Run,Original size,Consecutive Compression (ns),Consecutive Size,Consecutive Decompression (ns),Consective Total Time (ns),Consecutive Get (ns),Non-Consecutive Compression (ns),Non-Consecutive Size,Non-Consecutive Decompression (ns),Non-Consecutive Total Time (ns),Non-Consecutive Get (ns),Overflow Compression (ns),Overflow Size,Overflow Decompression (ns),Overflow Total Time (ns),Overflow Get (ns)
0,31131,2703625,30159,2974083,5677708,1917,2768167,31131,3570000,6338167,3708,20653625,31131,22518750,43172375,10167
1,40789,2748250,39515,645500,3393750,2875,1248833,40789,729042,1977875,2125,24828208,40789,631667,25459875,2542
2,9128,846459,8843,124125,970584,1208,145250,9128,126833,272083,834,5007250,9128,621583,5628833,4084
3,7739,497959,7498,114125,612084,1250,820375,7739,108458,928833,709,4076000,7739,460333,4536333,1041
4,59012,3549333,57168,792708,4342041,1083,1110000,59012,821625,1931625,708,29177167,59012,799584,29976751,2959
5,20184,1144083,19554,265958,1410041,1208,271208,20184,276708,547916,666,10355083,20184,271709,10626792,2208
6,36679,1984917,35533,480875,2465792,1083,833042,36679,495666,1328708,750,19597833,36679,563416,20161249,3542
7,34342,1866875,33269,446416,2313291,1000,456125,34342,464208,920333,875,16943958,34342,517708,17461666,3250
8,16376,950083,15865,234708,1184791,1125,260042,16376,244375,504417,917,6629292,16376,236750,6866042,2042
9,68133,4090500,66004,1239959,5330459,3041,1034167,68133,1015167,2049334,1375,26453875,68133,958625,27412500,3666
10,66393,3764292,64319,852708,4617000,1250,965833,66393,944750,1910583,792,24067000,66393,951334,25018334,3500
11,69922,3892333,67737,905084,4797417,1375,1357292,69922,936833,2294125,667,26082625,69922,1008875,27091500,1875
12,76573,4201750,74181,983917,5185667,1375,1013917,76573,1025625,2039542,666,29974042,76573,1136125,31110167,4375
13,61827,3373209,59895,803792,4177001,1041,1286458,61827,825583,2112041,583,22666958,61827,799041,23465999,2667
14,12660,683417,12265,165500,848917,1000,186666,12660,169458,356124,583,4922833,12660,166625,5089458,1875
15,52594,2838000,50951,674833,3512833,1208,1035625,52594,705042,1740667,666,19210167,52594,705500,19915667,3417
16,1407,78833,1364,19375,98208,1000,19625,1407,19666,39291,542,521458,1407,18833,540291,583
17,87015,4676000,84296,1117167,5793167,875,1185209,87015,1177792,2363001,542,32146875,87015,1253875,33400750,3167
18,16037,877542,15536,206667,1084209,1250,213084,16037,214500,427584,583,5566292,16037,217958,5784250,1667
19,35225,1946875,34125,453875,2400750,1125,466708,35225,470958,937666,541,12106333,35225,457292,12563625,833
20,77746,4202875,75317,1003333,5206208,833,1024917,77746,1038000,2062917,583,26920417,77746,1117500,28037917,3625
21,12408,680834,12021,160750,841584,1041,241833,12408,166000,407833,625,5028541,12408,171958,5200499,1375
22,15186,893458,14712,200292,1093750,1042,204583,15186,208000,412583,625,6065958,15186,232208,6298166,2125
23,18193,1152458,17625,261417,1413875,1875,266583,18193,251458,518041,666,6306667,18193,250291,6556958,708
24,42519,2296209,41191,565958,2862167,875,586291,42519,571417,1157708,500,15201542,42519,613250,15814792,2250
25,40218,2151834,38962,563250,2715084,1709,548958,40218,558916,1107874,1125,14590041,40218,517750,15107791,2000
26,36775,1969250,35626,473917,2443167,1292,801875,36775,494625,1296500,667,13575583,36775,508917,14084500,2166
27,41154,2280459,39868,554084,2834543,1250,841791,41154,563459,1405250,584,15044791,41154,554083,15598874,2166
28,10375,553667,10051,133500,687167,875,137792,10375,138708,276500,583,3632833,10375,149500,3782333,667
29,52944,2855042,51290,679791,3534833,833,695250,52944,707167,1402417,417,18616084,52944,685750,19301834,1459
30,2259,120541,2189,30083,150624,917,30125,2259,30417,60542,500,779417,2259,29542,808959,542
31,40769,2181416,39495,523583,2704999,792,561333,40769,575042,1136375,416,14524292,40769,565500,15089792,2625
32,88223,4726958,85467,1135125,5862083,834,1211750,88223,1180333,2392083,459,30836916,88223,1137833,31974749,1208
33,84377,4613625,81741,1084125,5697750,1916,1108292,84377,1132500,2240792,750,30560333,84377,1140792,31701125,1541
34,45269,2424333,43855,581667,3006000,917,596333,45269,604416,1200749,500,15849375,45269,585041,16434416,625
35,51400,2766542,49794,659625,3426167,792,684959,51400,686334,1371293,459,18411625,51400,662209,19073834,1084
36,81754,4438083,79200,1092875,5530958,917,1577959,81754,1091875,2669834,542,29028000,81754,1054458,30082458,2708
37,55401,2996625,53670,711792,3708417,1083,1017625,55401,787750,1805375,1041,19312625,55401,718083,20030708,2208
38,50234,2690042,48665,645041,3335083,958,1034000,50234,733792,1767792,583,17953208,50234,655958,18609166,1083
39,4331,232041,4196,56167,288208,917,84375,4331,58292,142667,542,1509166,4331,56000,1565166,541
40,79093,4267459,76622,1018625,5286084,750,1103667,79093,1098875,2202542,708,28719333,79093,1089917,29809250,3500
41,13229,741666,12816,174708,916374,1083,185125,13229,196541,381666,625,4909417,13229,172708,5082125,1792
42,23114,1351208,22392,297583,1648791,1000,327875,23114,344667,672542,750,8133417,23114,298625,8432042,625
43,34001,1828917,32939,436542,2265459,750,493458,34001,454125,947583,458,11949291,34001,481541,12430832,1042
44,1474,87167,1428,19292,106459,917,29083,1474,20041,49124,458,521667,1474,19125,540792,458
45,40619,2176000,39350,521750,2697750,667,531833,40619,543041,1074874,500,14484250,40619,524167,15008417,916
46,75500,4099833,73141,977041,5076874,833,993208,75500,1008375,2001583,584,27287500,75500,1064208,28351708,1167
47,29700,1633458,28772,412667,2046125,1500,388958,29700,396750,785708,584,10646292,29700,401833,11048125,834
48,50040,2681083,48477,646417,3327500,833,687875,50040,710000,1397875,625,17672250,50040,695584,18367834,584
49,34652,1861542,33570,449167,2310709,958,457125,34652,462708,919833,625,12712208,34652,451125,13163333,958
50,70435,3798917,68234,944583,4743500,1042,921042,70435,951125,1872167,584,24901500,70435,946792,25848292,1333
51,96986,5244416,93956,1249625,6494041,959,1296167,96986,1298250,2594417,500,34465625,96986,1313041,35778666,1875
52,5567,301917,5394,71875,373792,875,108083,5567,74750,182833,583,2182875,5567,72333,2255208,834
53,93088,5061083,90179,1197834,6258917,792,1228000,93088,1278666,2506666,667,32826791,93088,1204958,34031749,1500
54,84943,4569000,82289,1089833,5658833,875,1184792,84943,1188042,2372834,958,29900583,84943,1151042,31051625,1250
55,34016,1893125,32953,440916,2334041,1250,445750,34016,454250,900000,625,12177333,34016,440667,12618000,708
56,74400,4038291,72075,955750,4994041,833,977958,74400,993167,1971125,500,26371042,74400,1035958,27407000,917
57,6252,340875,6057,83042,423917,875,96125,6252,88042,184167,500,2160958,6252,81292,2242250,459
58,22495,1230333,21793,289125,1519458,709,325458,22495,300500,625958,459,7858333,22495,289375,8147708,500
59,86538,4717791,83834,1113708,5831499,1417,1238042,86538,1155792,2393834,625,30929292,86538,1119542,32048834,2417
60,22487,1213083,21785,289375,1502458,958,442541,22487,300875,743416,500,7863667,22487,310417,8174084,625
61,64245,3503583,62238,824500,4328083,917,843709,64245,857875,1701584,542,22902167,64245,879750,23781917,1000
62,24467,1313500,23703,314083,1627583,833,477167,24467,327000,804167,459,8662042,24467,328917,8990959,1333
63,94034,5096625,91096,1206708,6303333,1042,1234333,94034,1258000,2492333,583,33820083,94034,1219208,35039291,9041
64,90301,4833125,87480,1164750,5997875,6667,1256750,90301,1221333,2478083,625,31789833,90301,1166834,32956667,1416
65,12577,708667,12184,161792,870459,1041,272042,12577,168166,440208,500,4468917,12577,195708,4664625,500
66,26808,1536625,25971,373250,1909875,1750,351792,26808,358250,710042,709,9302375,26808,388500,9690875,459
67,73046,3921375,70764,1006416,4927791,834,986917,73046,978375,1965292,458,25783209,73046,1034583,26817792,667
68,59096,3180750,57250,807083,3987833,708,1155458,59096,792083,1947541,458,21198417,59096,762209,21960626,1375
69,47108,2540750,45636,605250,3146000,875,620625,47108,629084,1249709,500,16404292,47108,605167,17009459,584
70,19886,1063083,19265,255667,1318750,708,385333,19886,265542,650875,375,6928917,19886,255792,7184709,875
71,8334,452958,8074,107708,560666,833,109708,8334,111500,221208,458,2916792,8334,111791,3028583,459
72,57860,3120834,56052,763125,3883959,667,761542,57860,772917,1534459,417,20904041,57860,776333,21680374,958
73,152,8667,148,2125,10792,708,3209,152,2125,5334,458,59334,152,2084,61418,375
74,62323,3343042,60376,808000,4151042,625,822417,62323,836833,1659250,417,22596416,62323,811250,23407666,959
75,35900,2024792,34779,461000,2485792,917,470625,35900,479500,950125,541,12563500,35900,539208,13102708,458
76,10715,572833,10381,138041,710874,666,140500,10715,146041,286541,500,3793500,10715,155125,3948625,459
77,68971,3741083,66816,888083,4629166,625,1345708,68971,921083,2266791,375,24679584,68971,924708,25604292,833
78,6142,329000,5951,79375,408375,750,119125,6142,82625,201750,458,2145208,6142,79417,2224625,750
79,24796,1331375,24022,318583,1649958,667,483333,24796,332584,815917,416,8631750,24796,319750,8951500,541
80,91909,4918833,89037,1205250,6124083,708,1212167,91909,1229958,2442125,375,32813125,91909,1212375,34025500,875
81,11105,615166,10758,149708,764874,958,242250,11105,163333,405583,750,3971000,11105,154291,4125291,792
82,16262,894000,15754,208959,1102959,583,212791,16262,220417,433208,416,6106709,16262,214333,6321042,916
83,9121,521708,8836,117250,638958,833,119708,9121,122083,241791,417,3149875,9121,122708,3272583,333
84,4895,274125,4743,64542,338667,667,94375,4895,65708,160083,333,1686458,4895,66291,1752749,375
85,1810,110209,1754,26042,136251,625,39083,1810,27208,66291,417,644917,1810,24375,669292,458
86,42828,2367542,41490,549000,2916542,542,572083,42828,575291,1147374,417,15278500,42828,552250,15830750,417
87,15244,820166,14768,196000,1016166,583,202209,15244,203709,405918,375,5584584,15244,219833,5804417,375
88,49803,2670417,48247,641333,3311750,458,661250,49803,665416,1326666,333,17800500,49803,648792,18449292,916
89,37672,2032416,36495,484125,2516541,625,492458,37672,506125,998583,375,13238333,37672,489709,13728042,791
90,60956,3333000,59052,787417,4120417,834,800375,60956,815000,1615375,459,22298750,60956,874667,23173417,833
91,64661,3516584,62641,839417,4356001,1167,854125,64661,863541,1717666,583,22913750,64661,832083,23745833,500
92,61929,3338250,59994,798583,4136833,834,810750,61929,872167,1682917,375,22367375,61929,840042,23207417,417
93,13633,732500,13207,175459,907959,667,266333,13633,182291,448624,417,4975666,13633,196917,5172583,459
94,62475,3393708,60523,813417,4207125,666,818500,62475,880541,1699041,375,23373958,62475,857792,24231750,416
95,28964,1624333,28059,372584,1996917,625,381917,28964,387042,768959,375,10718791,28964,416667,11135458,1250
96,10219,549542,9900,131416,680958,542,134541,10219,138875,273416,375,3735083,10219,148333,3883416,458
97,72781,3920959,70507,943334,4864293,541,959375,72781,980042,1939417,375,27018417,72781,987291,28005708,833
98,88563,4745542,85796,1140791,5886333,667,1716833,88563,1183958,2900791,375,31720416,88563,1193416,32913832,917
99,13177,721666,12766,169334,891000,8042,190542,13177,176584,367126,2209,4739834,13177,182333,4922167,500
100,83857,4495500,81237,1085917,5581417,916,1143708,83857,1119417,2263125,542,30530625,83857,1123625,31654250,875
101,75221,4097250,72871,1024125,5121375,333,1457250,75221,1004416,2461666,209,27638250,75221,1001583,28639833,792
102,31437,1685000,30455,403917,2088917,292,412042,31437,419917,831959,125,11405833,31437,452417,11858250,500
103,45995,2471167,44558,590625,3061792,125,842333,45995,614167,1456500,83,16513833,45995,594167,17108000,917
104,63961,3424667,61963,825417,4250084,250,844167,63961,858000,1702167,209,23052250,63961,824750,23877000,500
105,15646,845625,15158,201292,1046917,167,269125,15646,209250,478375,125,5833459,15646,215875,6049334,583
106,15436,861250,14954,198375,1059625,167,324000,15436,206500,530500,125,5631083,15436,213083,5844166,500
107,63393,3391167,61412,870125,4261292,167,1607125,63393,917291,2524416,167,22968250,63393,858167,23826417,666
108,43740,2339166,42374,561584,2900750,208,751625,43740,583708,1335333,167,16040208,43740,628667,16668875,833
109,55264,2959291,53537,713542,3672833,167,949459,55264,746875,1696334,167,20107667,55264,728292,20835959,708
110,58399,3131583,56575,750459,3882042,167,1177750,58399,1009166,2186916,416,20498292,58399,785042,21283334,833
111,37694,2020208,36517,484875,2505083,208,649041,37694,503791,1152832,250,13690708,37694,537167,14227875,583
112,52958,2836083,51304,688083,3524166,208,697167,52958,716875,1414042,208,18506333,52958,714500,19220833,625
113,16028,857167,15528,206125,1063292,125,280209,16028,214250,494459,125,5761333,16028,223500,5984833,459
114,29742,1655834,28813,385875,2041709,83,594166,29742,397667,991833,125,11021166,29742,384625,11405791,708
115,58987,3160584,57144,758250,3918834,167,776792,58987,791834,1568626,167,20732666,58987,793333,21525999,583
116,13832,748041,13400,178167,926208,209,241084,13832,185084,426168,125,5056834,13832,188167,5245001,500
117,61641,3481125,59715,815750,4296875,292,1175584,61641,922042,2097626,167,23269042,61641,827458,24096500,3042
118,82901,4448250,80311,1068875,5517125,334,1436584,82901,1114875,2551459,167,30337333,82901,1193292,31530625,917
119,15101,808375,14630,194708,1003083,333,293500,15101,202125,495625,208,5437542,15101,200125,5637667,625
120,22222,1199666,21528,285292,1484958,208,385125,22222,296500,681625,167,8064583,22222,293250,8357833,500
121,54826,2966125,53113,703750,3669875,292,947084,54826,732917,1680001,250,19997917,54826,769166,20767083,750
122,47614,2552167,46127,612625,3164792,209,702917,47614,636291,1339208,167,17211166,47614,640208,17851374,583
123,79076,4250083,76605,1019166,5269249,125,1364875,79076,1057209,2422084,166,28481417,79076,1070834,29552251,1084
124,67295,3643958,65193,868000,4511958,250,887834,67295,1008875,1896709,334,25307833,67295,898667,26206500,1250
125,10743,579334,10408,138166,717500,208,210000,10743,143875,353875,250,3935750,10743,148625,4084375,792
126,46586,2525583,45131,599125,3124708,250,816625,46586,623000,1439625,125,17253958,46586,638875,17892833,958
127,41036,2211750,39754,528125,2739875,166,712750,41036,548708,1261458,167,15518750,41036,637708,16156458,5167
128,74184,3986083,71866,953833,4939916,125,1296416,74184,1003125,2299541,125,27606250,74184,959167,28565417,1000
129,95325,5122125,92347,1227209,6349334,334,1248666,95325,1273750,2522416,167,34206208,95325,1285333,35491541,541
130,33259,1782209,32220,430834,2213043,292,441167,33259,443917,885084,208,11843000,33259,460500,12303500,458
131,3859,226708,3739,52542,279250,125,68792,3859,53167,121959,166,1347875,3859,59916,1407791,125
132,39344,2191750,38115,505542,2697292,167,683000,39344,525958,1208958,125,14623833,39344,571750,15195583,125
133,60476,3238208,58587,781333,4019541,167,1018917,60476,820875,1839792,375,21251792,60476,815541,22067333,250
134,51607,2760958,49995,664208,3425166,209,1004084,51607,700125,1704209,125,18875708,51607,742333,19618041,292
135,81555,4371333,79007,1050500,5421833,208,1067708,81555,1092708,2160416,125,29670750,81555,1096708,30767458,125
136,95887,5220000,92891,1231667,6451667,166,1353958,95887,1281417,2635375,209,35112375,95887,1370083,36482458,417
137,48497,2597250,46982,623125,3220375,84,635334,48497,713167,1348501,166,17572167,48497,687958,18260125,584
138,25814,1381625,25008,332000,1713625,125,452541,25814,345125,797666,125,9404375,25814,334584,9738959,125
139,58428,3129041,56603,754125,3883166,125,1207333,58428,784000,1991333,125,21229000,58428,822083,22051083,250
140,25561,1372584,24763,328542,1701126,208,335958,25561,341875,677833,167,9357208,25561,331125,9688333,167
141,28989,1569791,28084,397500,1967291,167,501459,28989,387625,889084,125,10747583,28989,400750,11148333,208
142,53534,2872375,51862,688042,3560417,209,792334,53534,715250,1507584,125,19278667,53534,690958,19969625,125
143,55973,3049750,54224,748917,3798667,84,1020792,55973,776250,1797042,125,20523208,55973,762000,21285208,125
144,95589,5173958,92602,1228375,6402333,167,1252958,95589,1280667,2533625,209,34551583,95589,1267500,35819083,1125
145,29362,1588750,28445,377000,1965750,375,394042,29362,393333,787375,333,10433875,29362,398750,10832625,209
146,34521,1849625,33443,444000,2293625,167,630250,34521,464833,1095083,125,12878208,34521,463875,13342083,125
147,94791,5077708,91829,1219750,6297458,125,1678083,94791,1267292,2945375,167,34114625,94791,1253459,35368084,667
148,4741,254208,4593,61375,315583,208,91791,4741,63625,155416,167,1643291,4741,63792,1707083,166
149,91741,4913750,88875,1180041,6093791,209,1583041,91741,1224583,2807624,125,33449625,91741,1227625,34677250,417
150,94776,5076417,91815,1216958,6293375,334,1820417,94776,1266583,3087000,209,34554833,94776,1260125,35814958,458
151,2663,143250,2580,34542,177792,417,51625,2663,35875,87500,458,912000,2663,35917,947917,125
152,75571,4050000,73210,969667,5019667,167,1585750,75571,1074000,2659750,125,27916667,75571,1139917,29056584,167
153,80130,4320792,77626,1030083,5350875,333,1050208,80130,1073834,2124042,167,29317917,80130,1106167,30424084,375
154,31506,1709834,30522,408542,2118376,291,605333,31506,421000,1026333,166,11605667,31506,478958,12084625,125
155,84140,4507125,81511,1080875,5588000,208,1458375,84140,1135708,2594083,166,30856917,84140,1292333,32149250,500
156,69284,3756250,67119,890666,4646916,167,905667,69284,925166,1830833,167,24703375,69284,901459,25604834,250
157,28574,1536250,27682,367583,1903833,250,383000,28574,381750,764750,208,10497000,28574,395125,10892125,166
158,84834,4644375,82183,1091125,5735500,250,1891042,84834,1142584,3033626,84,31857459,84834,1281584,33139043,291
159,11936,638167,11563,153709,791876,209,231792,11936,159541,391333,292,4422125,11936,165666,4587791,125
160,20812,1181291,20162,271917,1453208,166,358208,20812,278042,636250,125,7864833,20812,271667,8136500,209
161,63409,3409625,61428,812375,4222000,209,828459,63409,846750,1675209,167,22468875,63409,849916,23318791,125
162,89946,4964542,87136,1154083,6118625,209,1553125,89946,1202250,2755375,125,33478875,89946,1294042,34772917,417
163,26836,1438750,25998,344000,1782750,208,727083,26836,388833,1115916,125,9887667,26836,355333,10243000,375
164,99596,5335000,96484,1276959,6611959,125,1716875,99596,1340083,3056958,83,35906500,99596,1368042,37274542,458
165,23143,1240708,22420,510500,1751208,417,303167,23143,309084,612251,84,8083584,23143,313541,8397125,125
166,37023,1998125,35867,474584,2472709,250,668958,37023,497458,1166416,83,13351792,37023,494041,13845833,83
167,91101,4879958,88255,1170875,6050833,167,1847500,91101,1217167,3064667,166,33255334,91101,1227000,34482334,292
168,85233,4667625,82570,1097375,5765000,541,1117583,85233,1138291,2255874,250,31909750,85233,1132292,33042042,333
169,40341,2158834,39081,518583,2677417,416,530459,40341,539083,1069542,292,14863666,40341,561125,15424791,125
170,6437,352667,6236,85750,438417,167,117167,6437,88250,205417,125,2304083,6437,89291,2393374,167
171,20989,1171959,20334,269959,1441918,167,404958,20989,280708,685666,125,7890916,20989,291208,8182124,125
172,52781,2842208,51132,679709,3521917,125,910167,52781,705875,1616042,125,19658084,52781,731375,20389459,250
173,5345,296875,5178,69167,366042,166,92542,5345,71709,164251,166,1913750,5345,77375,1991125,542
174,28269,1564750,27386,363750,1928500,125,654750,28269,383250,1038000,166,10570375,28269,397500,10967875,167
175,80694,4321334,78173,1049125,5370459,167,1060375,80694,1085584,2145959,167,30130000,80694,1103500,31233500,125
176,75927,4064875,73555,975500,5040375,167,1306541,75927,1018042,2324583,125,28565125,75927,1049583,29614708,208
177,23509,1256375,22775,302750,1559125,167,427667,23509,314500,742167,125,8866000,23509,303167,9169167,208
178,94135,5111333,91194,1213542,6324875,125,1243583,94135,1267292,2510875,209,33748708,94135,1279334,35028042,625
179,35687,1909750,34572,458292,2368042,167,696458,35687,477000,1173458,125,12852625,35687,502542,13355167,583
180,67730,3630750,65614,868917,4499667,166,1169459,67730,913084,2082543,166,24869417,67730,875416,25744833,542
181,21466,1148000,20796,277000,1425000,250,283458,21466,287125,570583,125,7472000,21466,310333,7782333,167
182,17368,950834,16826,250500,1201334,167,309791,17368,232458,542249,167,6268584,17368,240709,6509293,166
183,61895,3321250,59961,796625,4117875,167,1074167,61895,827583,1901750,125,22884250,61895,894542,23778792,208
184,1665,97417,1613,22208,119625,125,22750,1665,23125,45875,125,589042,1665,21542,610584,83
185,79137,4244625,76664,1017459,5262084,166,1364250,79137,1057583,2421833,125,28851000,79137,1073500,29924500,459
186,80878,4339500,78351,1155875,5495375,334,1199334,80878,1081000,2280334,250,29608625,80878,1081208,30689833,458
187,83029,4450792,80435,1069000,5519792,208,1903667,83029,1109875,3013542,125,31253417,83029,1145708,32399125,1375
188,92129,5468833,89250,1316334,6785167,542,1330125,92129,1339875,2670000,375,35722125,92129,1268875,36991000,4667
189,17577,1004208,17028,226375,1230583,375,232750,17577,235209,467959,250,6525792,17577,276833,6802625,458
190,17664,1039167,17112,242625,1281792,167,303625,17664,236042,539667,125,6622000,17664,228959,6850959,375
191,85743,4639083,83064,1106916,5745999,417,1776875,85743,1144708,2921583,209,31473125,85743,1133125,32606250,375
192,43280,2576667,41928,557209,3133876,459,566917,43280,586333,1153250,208,15705708,43280,629083,16334791,333
193,74572,3991500,72242,961500,4953000,208,1288834,74572,995834,2284668,125,27541958,74572,1000292,28542250,583
194,78581,4211708,76126,1009292,5221000,334,1030834,78581,1049208,2080042,375,28824709,78581,1020667,29845376,666
195,59078,3176791,57232,762417,3939208,125,1144667,59078,789167,1933834,166,21785625,59078,822833,22608458,125
196,88821,4768666,86046,1141583,5910249,125,1534334,88821,1202291,2736625,83,32293000,88821,1188500,33481500,167
197,37504,2013541,36332,481083,2494624,209,491125,37504,500959,992084,125,13826500,37504,488542,14315042,209
198,35456,1899250,34348,455792,2355042,167,464750,35456,473500,938250,167,12700583,35456,469792,13170375,416
199,25026,1340334,24244,321958,1662292,125,444208,25026,334458,778666,167,9315042,25026,349791,9664833,125
200,55665,2991292,53926,715417,3706709,125,1082125,55665,743542,1825667,125,20961833,55665,752958,21714791,709
201,75209,4037167,72859,964917,5002084,375,984417,75209,1014125,1998542,250,27653833,75209,1084375,28738208,333
202,36875,1972584,35723,473292,2445876,292,486250,36875,492458,978708,166,13615792,36875,518583,14134375,250
203,5283,282750,5118,68125,350875,167,91917,5283,71000,162917,167,1854167,5283,73167,1927334,125
204,44669,2432000,43274,572792,3004792,125,771709,44669,596375,1368084,125,16677042,44669,640292,17317334,375
205,98801,5304792,95714,1271666,6576458,209,1714333,98801,1323750,3038083,84,36405166,98801,1283708,37688874,833
206,47465,2544709,45982,611000,3155709,416,621875,47465,633875,1255750,167,17082750,47465,638417,17721167,333
207,32021,1713167,31021,411084,2124251,208,551125,32021,427792,978917,167,11795041,32021,460584,12255625,208
208,58325,3120750,56503,749166,3869916,167,1014792,58325,778791,1793583,83,21173500,58325,876458,22049958,625
209,77243,4140250,74830,991042,5131292,334,1123834,77243,1031334,2155168,292,28370583,77243,1044125,29414708,958
210,83823,4487125,81204,1076417,5563542,209,1129000,83823,1119542,2248542,167,30971584,83823,1084333,32055917,417
211,67025,3583542,64931,873667,4457209,166,876584,67025,898042,1774626,125,24245292,67025,928291,25173583,125
212,71151,3820208,68928,912708,4732916,166,1240500,71151,949791,2190291,125,26551167,71151,967292,27518459,125
213,60413,3247916,58526,803459,4051375,167,1165625,60413,806334,1971959,167,22082208,60413,781625,22863833,625
214,61867,3318000,59934,794417,4112417,292,819333,61867,826167,1645500,125,22848000,61867,886541,23734541,542
215,81610,4379458,79060,1052583,5432041,208,1889959,81610,1101000,2990959,125,30721542,81610,1184791,31906333,167
216,14550,832667,14096,189041,1021708,167,190708,14550,194500,385208,125,5385209,14550,202208,5587417,167
217,96802,5253416,93777,1261750,6515166,125,1669584,96802,1368500,3038084,125,36650500,96802,1353833,38004333,458
218,3652,211167,3538,50833,262000,208,68000,3652,52875,120875,292,1355583,3652,51250,1406833,167
219,89295,4817084,86505,1150917,5968001,125,1735833,89295,1260917,2996750,84,31881292,89295,1284042,33165334,291
220,15565,835375,15079,200209,1035584,208,204083,15565,208000,412083,167,5922958,15565,225250,6148208,83
221,14711,794208,14252,188959,983167,167,253000,14711,196625,449625,125,5378333,14711,208541,5586874,83
222,61850,3313375,59918,792791,4106166,167,1256125,61850,829000,2085125,125,22869833,61850,869042,23738875,166
223,69135,3727833,66975,889625,4617458,125,1247791,69135,923042,2170833,125,24959292,69135,991000,25950292,375
224,40608,2172500,39339,521959,2694459,167,787042,40608,545708,1332750,125,15130791,40608,547834,15678625,208
225,47621,2549542,46133,611291,3160833,292,627833,47621,635792,1263625,125,17066000,47621,663042,17729042,291
226,64884,3471125,62857,833333,4304458,125,1197292,64884,867208,2064500,125,23911291,64884,879916,24791207,292
227,50289,2688167,48718,650250,3338417,208,659500,50289,672375,1331875,209,18558833,50289,690750,19249583,125
228,54264,2908333,52569,697833,3606166,208,1206750,54264,725375,1932125,167,19939583,54264,745916,20685499,208
229,78306,4190625,75859,1005875,5196500,208,1029750,78306,1046500,2076250,167,29099708,78306,1062958,30162666,208
230,90356,4834834,87533,1167667,6002501,250,2379958,90356,1211375,3591333,167,33585833,90356,1264125,34849958,292
231,4651,251959,4506,60375,312334,500,61125,4651,62667,123792,125,1700542,4651,64542,1765084,125
232,14368,796333,13919,184625,980958,167,274542,14368,210084,484626,166,5233292,14368,199791,5433083,375
233,18517,1020500,17939,238250,1258750,208,336417,18517,253500,589917,83,6803708,18517,260542,7064250,125
234,22665,1233750,21957,291708,1525458,125,391625,22665,303500,695125,125,8316291,22665,325958,8642249,83
235,11626,647459,11263,150125,797584,125,261875,11626,155708,417583,125,4342958,11626,160250,4503208,458
236,35792,1953000,34674,461208,2414208,125,734542,35792,478584,1213126,125,12929625,35792,463417,13393042,208
237,908,49208,880,11834,61042,208,17917,908,12250,30167,125,317958,908,12250,330208,167
238,91338,4924584,88484,1173125,6097709,209,1760708,91338,1241666,3002374,167,33527875,91338,1227834,34755709,208
239,47888,2576417,46392,615083,3191500,167,633375,47888,640209,1273584,125,17548292,47888,659000,18207292,125
240,586,33375,568,7792,41167,166,10459,586,7917,18376,83,205000,586,8042,213042,167
241,13863,740083,13430,178250,918333,125,238166,13863,185458,423624,167,5076292,13863,201167,5277459,125
242,17111,949542,16577,220167,1169709,166,297375,17111,228708,526083,125,6429375,17111,225541,6654916,167
243,95617,5175625,92629,1231167,6406792,209,1265834,95617,1281042,2546876,83,35187750,95617,1231959,36419709,208
244,86628,4633250,83921,1113125,5746375,209,1145000,86628,1160167,2305167,166,31603834,86628,1154084,32757918,250
245,15981,862584,15482,205500,1068084,125,275625,15981,214083,489708,125,5848208,15981,205875,6054083,250
246,5277,315959,5113,72583,388542,209,71750,5277,72458,144208,125,1846167,5277,68416,1914583,125
247,81326,4403500,78785,1045541,5449041,208,1398292,81326,1090167,2488459,125,30226709,81326,1164542,31391251,250
248,55670,3072417,53931,715459,3787876,125,1079084,55670,744958,1824042,209,20638333,55670,770375,21408708,333
249,16153,908500,15649,207875,1116375,125,279791,16153,216083,495874,125,5974458,16153,249125,6223583,125
250,80149,4340875,77645,1053167,5394042,208,1484625,80149,1083458,2568083,125,29041916,80149,1117917,30159833,333
251,38896,2108417,37681,503334,2611751,208,509541,38896,519958,1029499,166,14385500,38896,562416,14947916,167
252,37807,2045709,36626,485583,2531292,209,496959,37807,505375,1002334,125,14015375,37807,548042,14563417,250
253,72913,3909458,70635,935959,4845417,167,1375458,72913,974500,2349958,166,26815417,72913,1103833,27919250,250
254,34747,1867500,33662,447000,2314500,250,457208,34747,464792,922000,125,12901625,34747,471000,13372625,167
255,36536,1972000,35395,469833,2441833,166,639625,36536,495875,1135500,166,13775292,36536,491250,14266542,125
256,4447,237917,4309,63084,301001,209,65334,4447,59834,125168,84,1586042,4447,64583,1650625,167
257,28875,1576042,27973,371375,1947417,125,743208,28875,386042,1129250,125,10626083,28875,418458,11044541,125
258,39523,2199042,38288,520291,2719333,125,701500,39523,543458,1244958,125,14957667,39523,579791,15537458,750
259,46172,2528792,44730,612916,3141708,208,814167,46172,632375,1446542,125,17400667,46172,641000,18041667,1125
260,14178,766416,13735,182667,949083,542,196958,14178,189833,386791,209,5215250,14178,196875,5412125,542
261,84644,4544042,81999,1126667,5670709,208,1766541,84644,1130083,2896624,167,31373666,84644,1140000,32513666,375
262,8328,445792,8068,107417,553209,167,162209,8328,111333,273542,125,3021042,8328,116041,3137083,125
263,53565,2880917,51892,690708,3571625,208,941500,53565,718625,1660125,125,19784667,53565,738541,20523208,167
264,27507,1474916,26648,354167,1829083,125,535292,27507,367416,902708,83,10359458,27507,380792,10740250,166
265,64561,3456791,62544,829250,4286041,125,1115583,64561,861875,1977458,125,24050584,64561,874875,24925459,125
266,12292,660167,11908,158000,818167,84,214209,12292,164375,378584,83,4690458,12292,159167,4849625,209
267,27314,1502125,26461,351208,1853333,166,529209,27314,364875,894084,125,9993959,27314,379500,10373459,167
268,96136,5186583,93132,1234458,6421041,167,1656750,96136,1293875,2950625,125,35513958,96136,1274083,36788041,709
269,70695,3790917,68486,917875,4708792,333,1028875,70695,949375,1978250,333,25991083,70695,910667,26901750,250
270,58293,3116292,56472,748167,3864459,125,766709,58293,785166,1551875,167,21104250,58293,784000,21888250,125
271,48191,2582542,46686,619375,3201917,209,1094083,48191,643958,1738041,125,17733083,48191,667458,18400541,459
272,80060,4354833,77559,1028667,5383500,208,1055750,80060,1069834,2125584,166,29957209,80060,1124000,31081209,125
273,33447,1787625,32402,430375,2218000,167,439167,33447,447292,886459,125,12334625,33447,468500,12803125,125
274,23404,1268750,22673,300750,1569500,125,406708,23404,312917,719625,125,8633458,23404,323333,8956791,125
275,84604,4551167,81961,1090250,5641417,83,1534375,84604,1159375,2693750,167,31275375,84604,1161000,32436375,667
276,1268,68750,1229,16709,85459,334,16875,1268,17250,34125,125,447667,1268,16459,464126,125
277,51151,2741541,49553,658250,3399791,125,1079250,51151,683625,1762875,125,18980917,51151,735125,19716042,584
278,90104,4835792,87289,1160084,5995876,250,1183375,90104,1204792,2388167,125,33335375,90104,1300959,34636334,125
279,17627,943792,17077,227292,1171084,250,231750,17627,235833,467583,166,6544209,17627,249250,6793459,84
280,54834,2974167,53121,740875,3715042,125,950541,54834,733584,1684125,208,20411000,54834,754542,21165542,125
281,25281,1392084,24491,325709,1717793,167,477542,25281,338042,815584,167,9675541,25281,353750,10029291,333
282,7775,437166,7533,100708,537874,167,136625,7775,104417,241042,125,2854208,7775,108125,2962333,166
283,75355,4081625,73001,971833,5053458,125,1410875,75355,1012792,2423667,125,28341750,75355,1090709,29432459,250
284,3598,208209,3486,46542,254751,125,70875,3598,48500,119375,125,1476458,3598,46834,1523292,167
285,15620,885916,15132,200959,1086875,166,301542,15620,209000,510542,167,5839958,15620,218333,6058291,167
286,37080,2036084,35922,495833,2531917,167,719416,37080,495500,1214916,125,13862708,37080,537167,14399875,125
287,22550,1244541,21846,289917,1534458,166,389292,22550,301417,690709,84,8266167,22550,310958,8577125,167
288,8832,510417,8556,122042,632459,250,154958,8832,118292,273250,125,3289542,8832,127875,3417417,125
289,62352,3371625,60404,802750,4174375,125,1380542,62352,834583,2215125,125,22343750,62352,886666,23230416,250
290,88696,4803542,85925,1138875,5942417,208,1167125,88696,1187000,2354125,125,32643625,88696,1180041,33823666,333
291,46012,2464334,44575,591250,3055584,209,606333,46012,615375,1221708,166,17028875,46012,651958,17680833,167
292,23910,1283875,23163,307791,1591666,167,537125,23910,319875,857000,83,8530208,23910,307833,8838041,167
293,52364,2817750,50728,673750,3491500,167,685208,52364,699917,1385125,167,19227166,52364,689792,19916958,167
294,28568,1528958,27676,367500,1896458,125,493750,28568,382000,875750,125,10567000,28568,407958,10974958,250
295,27923,1495708,27051,358917,1854625,208,421792,27923,373417,795209,125,10018500,27923,422292,10440792,125
296,40328,2181792,39068,534167,2715959,250,926500,40328,539375,1465875,125,14927750,40328,558125,15485875,459
297,4447,257500,4309,61916,319416,125,82833,4447,64000,146833,84,1654750,4447,64625,1719375,125
298,32089,1769416,31087,415542,2184958,125,762292,32089,469750,1232042,125,12344333,32089,444334,12788667,666
299,87901,4777375,85155,1133125,5910500,167,1605417,87901,1260166,2865583,208,32827500,87901,1189416,34016916,542
300,70882,3838959,68667,916334,4755293,333,931542,70882,947709,1879251,250,26569292,70882,986166,27555458,209
301,48154,2593459,46650,622791,3216250,167,833083,48154,643834,1476917,166,17722209,48154,670625,18392834,458
302,15368,822958,14888,198000,1020958,250,264834,15368,206000,470834,292,5584833,15368,213375,5798208,167
303,28914,1550958,28011,371667,1922625,166,501209,28914,387000,888209,125,10746958,28914,395750,11142708,167
304,82491,4412084,79914,1061917,5474001,250,1423625,82491,1102375,2526000,125,30231459,82491,1146833,31378292,417
305,66757,3570833,64671,860166,4430999,250,968000,66757,892375,1860375,166,24831084,66757,926584,25757668,333
306,89137,4797125,86352,1145416,5942541,167,1181208,89137,1278500,2459708,166,32878834,89137,1322667,34201501,1125
307,56764,3258000,54991,730000,3988000,542,1103625,56764,758209,1861834,292,20863458,56764,745458,21608916,209
308,88638,4788583,85869,1150458,5939041,333,1887250,88638,1192417,3079667,250,32798458,88638,1191875,33990333,416
309,4623,250541,4479,60250,310791,375,61333,4623,62167,123500,250,1628583,4623,71625,1700208,208
310,88037,4728667,85286,1144125,5872792,250,1828500,88037,1187542,3016042,166,32275125,88037,1149833,33424958,375
311,82695,4428666,80111,1063000,5491666,208,1082375,82695,1182500,2264875,166,31195792,82695,1151500,32347292,125
312,98259,5278541,95189,1264333,6542874,250,1328750,98259,1417417,2746167,166,35897500,98259,1295917,37193417,417
313,88969,4768208,86189,1144833,5913041,250,1178333,88969,1189083,2367416,167,32381166,88969,1304583,33685749,167
314,69452,3716167,67282,895750,4611917,250,956167,69452,931708,1887875,125,25544833,69452,961708,26506541,291
315,53660,2876875,51984,694500,3571375,250,1035750,53660,752209,1787959,209,19992000,53660,707042,20699042,125
316,5512,299792,5340,86458,386250,166,72625,5512,74041,146666,125,1884166,5512,74708,1958874,125
317,63628,3489167,61640,821666,4310833,209,1098708,63628,852166,1950874,83,22804292,63628,882417,23686709,333
318,78863,4226209,76399,1016375,5242584,125,1372167,78863,1054709,2426876,166,29023417,78863,1129916,30153333,708
319,58890,3153542,57050,761166,3914708,167,773166,58890,792666,1565832,250,21383750,58890,845959,22229709,2833
320,86638,4646375,83931,1117416,5763791,208,1168708,86638,1186875,2355583,208,32264833,86638,1167000,33431833,291
321,59889,3206833,58018,776083,3982916,166,799958,59889,803709,1603667,125,21723958,59889,820959,22544917,250
322,56259,3076584,54501,722625,3799209,208,1019625,56259,751833,1771458,167,20668542,56259,782125,21450667,208
323,79969,4278250,77470,1026750,5305000,292,1051958,79969,1097709,2149667,208,29755791,79969,1100708,30856499,167
324,80745,4326458,78222,1036334,5362792,167,1059958,80745,1079292,2139250,125,30010375,80745,1086125,31096500,500
325,97258,5252042,94219,1251083,6503125,209,1285333,97258,1303208,2588541,125,36119583,97258,1253334,37372917,250
326,25226,1350542,24438,323583,1674125,208,332667,25226,336625,669292,125,8992750,25226,349417,9342167,167
327,20799,1130458,20150,266958,1397416,167,359750,20799,278041,637791,125,7577500,20799,299458,7876958,459
328,61169,3310416,59258,784917,4095333,167,1068709,61169,817333,1886042,83,22734250,61169,849959,23584209,167
329,56321,3087750,54561,726500,3814250,208,832834,56321,752791,1585625,125,20763667,56321,783834,21547501,291
330,90601,4852041,87770,1177375,6029416,125,1564500,90601,1210834,2775334,84,33903917,90601,1245208,35149125,125
331,62105,3327709,60165,798875,4126584,167,812625,62105,830292,1642917,375,22576833,62105,839958,23416791,208
332,84343,4524959,81708,1090959,5615918,125,1108333,84343,1127709,2236042,125,31508208,84343,1169417,32677625,166
333,75109,4046667,72762,968750,5015417,167,1029833,75109,1080416,2110249,125,28114583,75109,966917,29081500,166
334,8657,464042,8387,111458,575500,166,125834,8657,115917,241751,125,3009125,8657,116333,3125458,125
335,83925,4517000,81303,1081334,5598334,125,1935042,83925,1164625,3099667,125,30947167,83925,1080125,32027292,833
336,93755,5083625,90826,1210542,6294167,292,1241208,93755,1256041,2497249,125,35248000,93755,1320333,36568333,500
337,28422,1555375,27534,369042,1924417,125,415292,28422,400000,815292,167,10688709,28422,395416,11084125,625
338,52906,2934041,51253,682375,3616416,167,944333,52906,758208,1702541,209,19947250,52906,761625,20708875,250
339,77320,4205083,74904,993959,5199042,125,1428167,77320,1111000,2539167,167,28390417,77320,1122209,29512626,625
340,55163,2977166,53440,752375,3729541,500,752333,55163,758708,1511041,333,20041292,55163,781083,20822375,333
341,96774,5225417,93750,1245541,6470958,292,1409250,96774,1312917,2722167,292,35725458,96774,1410084,37135542,500
342,36723,1967083,35576,474250,2441333,166,524125,36723,502375,1026500,250,13373541,36723,526959,13900500,333
343,87733,4735834,84992,1192959,5928793,500,1155667,87733,1171208,2326875,250,32254584,87733,1131959,33386543,417
344,96115,5193917,93112,1287917,6481834,292,1277792,96115,1347000,2624792,208,35684250,96115,1367375,37051625,709
345,10979,586208,10636,141375,727583,375,213292,10979,147042,360334,166,3950625,10979,147708,4098333,334
346,775,42917,751,10709,53626,125,14042,775,10875,24917,167,278667,775,11292,289959,125
347,92414,5070834,89527,1272667,6343501,167,2263584,92414,1263500,3527084,125,34736792,92414,1220875,35957667,1250
348,25086,1343792,24303,335583,1679375,417,519250,25086,335750,855000,333,9277125,25086,324375,9601500,334
349,22793,1245208,22081,296583,1541791,333,303333,22793,352208,655541,416,8069000,22793,327542,8396542,292
350,501,27583,486,7042,34625,208,9708,501,7042,16750,250,179584,501,6750,186334,125
351,74502,4022542,72174,956500,4979042,125,1283000,74502,1014541,2297541,125,27346208,74502,992542,28338750,500
352,37722,2025042,36544,485084,2510126,417,735208,37722,504500,1239708,416,13404625,37722,509292,13913917,584
353,68959,3793708,66805,907917,4701625,208,911416,68959,923667,1835083,167,25422291,68959,991167,26413458,583
354,44932,2464583,43528,591292,3055875,209,622209,44932,638750,1260959,458,16195208,44932,626166,16821374,459
355,6933,402291,6717,93416,495707,167,160791,6933,99958,260749,208,2455458,6933,89625,2545083,458
356,33302,1841417,32262,427291,2268708,125,581791,33302,453833,1035624,209,12366791,33302,447542,12814333,291
357,78162,4248250,75720,1003417,5251667,250,1023000,78162,1064000,2087000,167,28953833,78162,1043417,29997250,458
358,224,13084,217,3250,16334,209,3250,224,3125,6375,209,79125,224,3042,82167,167
359,37348,1997833,36181,482917,2480750,208,643667,37348,505250,1148917,125,13774375,37348,556459,14330834,417
360,79598,4305834,77111,1039042,5344876,334,1092834,79598,1258167,2351001,500,29167208,79598,1153750,30320958,917
361,70752,4064416,68541,928208,4992624,375,926292,70752,948000,1874292,167,25832250,70752,963500,26795750,833
362,39422,2247416,38191,573458,2820874,625,576750,39422,526708,1103458,292,14877542,39422,607916,15485458,459
363,8357,468542,8096,107791,576333,167,176083,8357,111916,287999,625,3064125,8357,116042,3180167,84
364,482,30500,467,6916,37416,3583,9167,482,7209,16376,708,187791,482,6917,194708,167
365,74718,4139583,72384,958833,5098416,167,1689792,74718,1023667,2713459,125,27768625,74718,1047500,28816125,584
366,80841,4322167,78315,1095416,5417583,459,1164042,80841,1090209,2254251,375,29591000,80841,1101459,30692459,666
367,79287,4281458,76810,1027250,5308708,417,1044041,79287,1066250,2110291,292,29358375,79287,1145667,30504042,750
368,29059,1593417,28151,377250,1970667,333,387417,29059,430917,818334,208,11057167,29059,375500,11432667,417
369,24037,1283708,23286,308583,1592291,375,465667,24037,321083,786750,167,8783541,24037,345167,9128708,125
370,84350,4610042,81715,1081000,5691042,375,1110084,84350,1127667,2237751,125,30997708,84350,1136209,32133917,625
371,23874,1295833,23128,307167,1603000,292,351709,23874,319250,670959,125,8726875,23874,343833,9070708,250
372,4197,241791,4066,58292,300083,125,88792,4197,60584,149376,166,1588917,4197,55167,1644084,333
373,9075,491166,8792,116792,607958,208,119292,9075,121542,240834,167,3167667,9075,117250,3284917,125
374,74777,4057917,72441,998416,5056333,292,1288791,74777,1033625,2322416,167,27312208,74777,1053209,28365417,542
375,98733,5356458,95648,1266750,6623208,375,1347584,98733,1480917,2828501,875,36398500,98733,1280333,37678833,625
376,69753,3828125,67574,948750,4776875,417,915375,69753,934917,1850292,250,25872875,69753,972250,26845125,917
377,39109,2175250,37887,506500,2681750,458,530167,39109,525667,1055834,333,14662334,39109,599542,15261876,1583
378,5871,347667,5688,84709,432376,459,114625,5871,80500,195125,292,2126166,5871,85625,2211791,208
379,74023,4034750,71710,998125,5032875,417,1010417,74023,989333,1999750,208,27331541,74023,1030208,28361749,791
380,45715,2655083,44287,587125,3242208,292,599417,45715,646458,1245875,125,17470625,45715,596334,18066959,875
381,70984,3904791,68766,911084,4815875,334,931667,70984,947792,1879459,333,26493875,70984,973125,27467000,750
382,5222,283333,5059,67417,350750,333,74500,5222,78208,152708,333,1941666,5222,79292,2020958,208
383,21427,1236042,20758,282584,1518626,166,381458,21427,292875,674333,167,8489792,21427,307125,8796917,2125
384,44060,2361542,42684,573708,2935250,125,592792,44060,619500,1212292,125,16028334,44060,632667,16661001,583
385,72474,3912750,70210,933875,4846625,334,947917,72474,1005291,1953208,333,26667084,72474,1060208,27727292,875
386,43194,2315750,41845,557375,2873125,500,570667,43194,588375,1159042,250,15800083,43194,673375,16473458,958
387,92189,5036750,89309,1186500,6223250,458,1218458,92189,1329333,2547791,333,34314958,92189,1293834,35608792,916
388,72499,3934791,70234,934458,4869249,500,954958,72499,1042625,1997583,250,26804125,72499,1044167,27848292,709
389,87392,4739167,84661,1136209,5875376,333,1222500,87392,1223209,2445709,500,33060958,87392,1145750,34206708,1000
390,5433,291041,5264,70750,361791,458,71625,5433,73084,144709,542,1900792,5433,73500,1974292,125
391,60087,3304375,58210,782459,4086834,875,1106875,60087,806250,1913125,125,22255500,60087,938458,23193958,1083
392,84636,4532000,81992,1109625,5641625,458,1158417,84636,1149000,2307417,292,31824084,84636,1190500,33014584,1333
393,65109,3851542,63075,886666,4738208,541,1045500,65109,975208,2020708,833,25568458,65109,940625,26509083,1625
394,85744,5113000,83065,1290750,6403750,1333,1268583,85744,1459583,2728166,667,32824417,85744,1107375,33931792,1208
395,34064,1843750,33000,471875,2315625,541,514042,34064,493583,1007625,250,12673042,34064,442958,13116000,625
396,26465,1435458,25638,341084,1776542,292,347166,26465,353542,700708,333,10109042,26465,383542,10492584,333
397,8275,441250,8017,109125,550375,375,110833,8275,110791,221624,167,2864000,8275,111250,2975250,125
398,45028,2444208,43621,595292,3039500,291,912625,45028,601208,1513833,125,16529792,45028,622916,17152708,583
399,4065,236958,3938,60167,297125,375,58458,4065,59917,118375,167,1452875,4065,56000,1508875,125
400,7100,415084,6879,98666,513750,209,157042,7100,105500,262542,166,2633792,7100,98917,2732709,167
401,31930,1844542,30933,411000,2255542,125,563917,31930,426708,990625,125,11943208,31930,443125,12386333,292
402,28074,1517375,27197,380459,1897834,417,396167,28074,375250,771417,292,10170041,28074,387667,10557708,125
403,2123,123875,2057,29625,153500,167,44458,2123,30708,75166,167,798750,2123,30834,829584,84
404,18045,991792,17482,232000,1223792,209,315791,18045,241084,556875,166,6570375,18045,232292,6802667,333
405,63191,3459333,61217,811125,4270458,250,829333,63191,845625,1674958,125,23420709,63191,822417,24243126,834
406,40612,2219709,39343,522834,2742543,250,534083,40612,542375,1076458,209,14798417,40612,525709,15324126,292
407,51881,2772625,50260,708125,3480750,209,689292,51881,692833,1382125,166,19109292,51881,749542,19858834,416
408,57667,3091667,55865,788042,3879709,250,777333,57667,825083,1602416,125,21349375,57667,837625,22187000,333
409,22211,1235042,21517,301000,1536042,209,294667,22211,296791,591458,209,8497166,22211,297917,8795083,250
410,68158,3668959,66029,874417,4543376,250,900000,68158,987708,1887708,250,25026333,68158,944667,25971000,584
411,80045,4328333,77544,1028083,5356416,292,1133042,80045,1149583,2282625,166,29984375,80045,1116083,31100458,959
412,91637,4938667,88774,1177916,6116583,333,1252375,91637,1312625,2565000,291,33413042,91637,1343958,34757000,458
413,88617,4780375,85848,1141083,5921458,250,1212666,88617,1272875,2485541,167,32942750,88617,1229959,34172709,292
414,43978,2424167,42604,568125,2992292,208,649625,43978,587292,1236917,166,16259125,43978,588792,16847917,291
415,55023,2964292,53304,709708,3674000,208,726833,55023,734875,1461708,167,20640583,55023,761042,21401625,291
416,77144,4198583,74734,989667,5188250,125,1337167,77144,1117083,2454250,125,28693458,77144,1078250,29771708,292
417,92860,5019584,89959,1202500,6222084,333,1214000,92860,1303542,2517542,291,34254375,92860,1290958,35545333,166
418,69223,3740833,67060,892458,4633291,167,906083,69223,979916,1885999,333,25680625,69223,930792,26611417,250
419,82112,4416041,79546,1053208,5469249,250,1076458,82112,1143167,2219625,208,30670333,82112,1058750,31729083,250
420,82452,4477666,79876,1067375,5545041,166,1106583,82452,1148708,2255291,167,30613208,82452,1143250,31756458,208
421,45395,2489625,43977,583375,3073000,167,784500,45395,606458,1390958,125,17346083,45395,657375,18003458,125
422,55664,3042375,53925,716708,3759083,209,958541,55664,794417,1752958,166,21068375,55664,738667,21807042,375
423,80028,4292083,77528,1029459,5321542,250,1046125,80028,1079834,2125959,208,29427166,80028,1074625,30501791,292
424,58796,3153958,56959,758292,3912250,167,1015291,58796,786000,1801291,125,22057834,58796,825625,22883459,250
425,68649,3697625,66504,884750,4582375,125,905875,68649,967958,1873833,166,25130875,68649,889375,26020250,208
426,15913,850041,15416,205500,1055541,333,312833,15913,213000,525833,167,5854625,15913,220459,6075084,125
427,96566,5231250,93549,1251375,6482625,166,1927250,96566,1324333,3251583,125,36424125,96566,1346375,37770500,125
428,49618,2783291,48068,644500,3427791,208,681334,49618,719083,1400417,166,18422167,49618,692625,19114792,125
429,45331,2575250,43915,583208,3158458,125,826000,45331,649583,1475583,167,16619167,45331,629792,17248959,208
430,12447,670000,12059,160208,830208,166,163209,12447,166500,329709,250,4518958,12447,172250,4691208,167
431,51346,2792625,49742,660333,3452958,125,902708,51346,694291,1596999,125,19097541,51346,661958,19759499,208
432,42099,2259291,40784,544000,2803291,208,551500,42099,568250,1119750,209,15530458,42099,583791,16114249,167
433,89556,4796792,86758,1170083,5966875,250,1545791,89556,1199792,2745583,125,33089042,89556,1204625,34293667,333
434,22513,1206375,21810,289542,1495917,125,296584,22513,302625,599209,250,8318625,22513,313375,8632000,125
435,44894,2467209,43492,577083,3044292,125,775625,44894,599375,1375000,125,16434959,44894,580250,17015209,500
436,92246,4942500,89364,1195750,6138250,166,1211667,92246,1257625,2469292,166,34216917,92246,1260916,35477833,250
437,97824,5237958,94767,1255291,6493249,209,1285084,97824,1403959,2689043,125,36474208,97824,1326458,37800666,291
438,83884,4500542,81263,1088959,5589501,209,1099917,83884,1130125,2230042,125,31132333,83884,1088167,32220500,334
439,46283,2489291,44837,595166,3084457,250,605834,46283,618375,1224209,125,17330208,46283,673041,18003249,125
440,98093,5334625,95028,1277000,6611625,334,1815959,98093,1413667,3229626,125,37260083,98093,1407083,38667166,375
441,79955,4432417,77457,1034417,5466834,209,1128292,79955,1145416,2273708,125,29260250,79955,1102458,30362708,166
442,21256,1142209,20592,273333,1415542,125,281417,21256,284041,565458,167,7824292,21256,326000,8150292,167
443,61431,3307042,59512,788791,4095833,167,1067167,61431,823250,1890417,167,23000333,61431,876542,23876875,167
444,18208,974667,17639,234125,1208792,166,239417,18208,243167,482584,125,6728209,18208,252250,6980459,125
445,31353,1706250,30374,402250,2108500,167,547667,31353,418667,966334,125,11682750,31353,431791,12114541,458
446,40847,2214417,39571,534041,2748458,83,719333,40847,545667,1265000,83,15527083,40847,629417,16156500,166
447,23257,1295667,22531,298625,1594292,125,305625,23257,310667,616292,167,8572250,23257,322292,8894542,125
448,1402,84542,1359,19916,104458,167,29833,1402,20541,50374,125,516666,1402,19542,536208,125
449,12080,719333,11703,155042,874375,125,210417,12080,161750,372167,84,4387500,12080,167625,4555125,125
450,40596,2227792,39328,521583,2749375,125,781458,40596,542625,1324083,83,15054541,40596,528875,15583416,167
451,82982,4442292,80389,1065958,5508250,167,1094041,82982,1112334,2206375,125,30780792,82982,1200083,31980875,125
452,94304,5131375,91357,1222583,6353958,125,1749583,94304,1351958,3101541,83,35157833,94304,1310500,36468333,333
453,30023,1666958,29085,386459,2053417,125,585708,30023,401458,987166,125,10774750,30023,416083,11190833,125
454,40893,2248875,39616,526042,2774917,125,535625,40893,549708,1085333,125,15048791,40893,552125,15600916,167
455,25962,1389875,25151,334167,1724042,84,447333,25962,347083,794416,83,9592209,25962,390083,9982292,125
456,17294,962375,16754,222500,1184875,125,298125,17294,231333,529458,167,6360542,17294,239750,6600292,209
457,16622,933166,16103,214000,1147166,166,322292,16622,222250,544542,167,6066834,16622,230292,6297126,167
458,23528,1292875,22793,302417,1595292,166,405834,23528,314708,720542,83,8668042,23528,326083,8994125,125
459,66137,3568084,64071,855833,4423917,167,1325792,66137,907208,2233000,125,24322333,66137,915000,25237333,333
460,12693,678125,12297,163417,841542,166,187334,12693,170042,357376,125,4609417,12693,177167,4786584,167
461,47628,2579292,46140,614500,3193792,125,824459,47628,637000,1461459,125,17613333,47628,663792,18277125,166
462,37182,2075500,36021,487750,2563250,167,694875,37182,509333,1204208,125,13892917,37182,521209,14414126,208
463,21989,1201833,21302,283000,1484833,208,292042,21989,294084,586126,125,8091417,21989,305583,8397000,125
464,83025,4480583,80431,1065917,5546500,166,1437167,83025,1148291,2585458,125,30582625,83025,1140292,31722917,625
465,89616,4802167,86816,1198625,6000792,333,1171416,89616,1233375,2404791,333,33095209,89616,1210250,34305459,458
466,88892,4766833,86115,1147042,5913875,209,1162667,88892,1263375,2426042,334,33585584,88892,1238333,34823917,292
467,13385,748084,12967,172375,920459,208,175917,13385,179041,354958,167,4984833,13385,201250,5186083,125
468,77871,4220834,75438,999792,5220626,167,1380542,77871,1042750,2423292,167,29498458,77871,1098708,30597166,250
469,77623,4187083,75198,1000084,5187167,166,1032917,77623,1115083,2148000,125,29057542,77623,1122167,30179709,333
470,25022,1360459,24241,321750,1682209,209,327750,25022,334125,661875,125,9315667,25022,369500,9685167,167
471,64758,3508542,62735,831000,4339542,250,1306667,64758,875166,2181833,125,24734708,64758,902042,25636750,208
472,15616,886042,15128,200792,1086834,292,231416,15616,208583,439999,125,5767333,15616,217458,5984791,125
473,98233,5393709,95164,1260875,6654584,125,2266958,98233,1325292,3592250,125,36665291,98233,1411417,38076708,375
474,42318,2264750,40996,545083,2809833,250,601500,42318,564459,1165959,417,15631833,42318,588208,16220041,167
475,53449,2901000,51779,686584,3587584,125,934083,53449,728792,1662875,125,19587625,53449,739541,20327166,334
476,51542,2790167,49932,669334,3459501,250,673959,51542,688459,1362418,167,19001833,51542,714209,19716042,125
477,93219,5036500,90306,1212583,6249083,167,1634583,93219,1306625,2941208,166,34884417,93219,1255917,36140334,625
478,81481,4366792,78935,1048792,5415584,250,1116709,81481,1095833,2212542,250,30818792,81481,1129417,31948209,291
479,37927,2047250,36742,487167,2534417,167,555541,37927,506500,1062041,125,14197125,37927,512666,14709791,208
480,64382,3470916,62371,845708,4316624,250,872292,64382,861042,1733334,167,23752708,64382,900625,24653333,167
481,39175,2117375,37951,504167,2621542,167,735666,39175,523875,1259541,83,14597250,39175,506041,15103291,208
482,65678,3518583,63626,843959,4362542,250,862917,65678,878125,1741042,208,24734083,65678,916417,25650500,125
483,61029,3286250,59122,795417,4081667,292,1054334,61029,832834,1887168,125,22584084,61029,880792,23464876,125
484,25951,1387000,25141,333917,1720917,167,339958,25951,347000,686958,125,9610083,25951,382500,9992583,250
485,67459,3650958,65351,868583,4519541,250,1168125,67459,909333,2077458,167,24938791,67459,899458,25838249,166
486,68695,3680042,66549,885500,4565542,250,902292,68695,918125,1820417,125,25255584,68695,924042,26179626,500
487,6408,346292,6208,82834,429126,208,84833,6408,86292,171125,125,2311875,6408,91250,2403125,125
488,95357,5121042,92378,1223458,6344500,208,1652833,95357,1322375,2975208,167,35174459,95357,1292667,36467126,208
489,75838,4055542,73469,972833,5028375,167,992083,75838,1011459,2003542,166,28103250,75838,1026584,29129834,250
490,51908,2784125,50286,670458,3454583,167,686042,51908,742750,1428792,125,19131792,51908,720333,19852125,125
491,7767,445500,7525,107416,552916,167,144084,7767,106500,250584,125,2821125,7767,112541,2933666,209
492,91033,4939000,88189,1173208,6112208,83,1607167,91033,1262167,2869334,125,33999208,91033,1336125,35335333,500
493,68041,3683625,65915,918125,4601750,209,895625,68041,909916,1805541,208,25072542,68041,948958,26021500,500
494,47003,2521917,45535,648375,3170292,208,624916,47003,628042,1252958,250,17504500,47003,655125,18159625,125
495,2467,147209,2390,34334,181543,125,46042,2467,35750,81792,83,916667,2467,38209,954876,125
496,61684,3348875,59757,797417,4146292,84,1063667,61684,835916,1899583,83,23520917,61684,852583,24373500,875
497,52131,2831834,50502,669542,3501376,292,761167,52131,796292,1557459,1458,20337917,52131,705791,21043708,1125
498,11407,700209,11051,180417,880626,583,209250,11407,176583,385833,750,4739709,11407,184958,4924667,1750
499,19957,1246958,19334,288083,1535041,1041,292625,19957,333459,626084,667,7998375,19957,264000,8262375,1000
500,79647,4682209,77159,1143083,5825292,1083,1183125,79647,1177333,2360458,1250,31520584,79647,1220458,32741042,1375
501,60176,3336875,58296,838708,4175583,583,860208,60176,870375,1730583,541,22465250,60176,889750,23355000,2209
502,88950,5056833,86171,1153000,6209833,458,1266958,88950,1335667,2602625,1333,35228583,88950,1157666,36386249,1833
503,66155,3688042,64088,940375,4628417,625,947375,66155,950084,1897459,667,25270000,66155,886750,26156750,750
504,68732,3757291,66585,981583,4738874,541,975375,68732,990667,1966042,458,25684833,68732,884625,26569458,1167
505,77116,4310666,74707,1093250,5403916,666,1088500,77116,1093250,2181750,584,28811375,77116,1057375,29868750,1250
506,4489,257541,4349,59875,317416,500,61000,4489,61917,122917,458,1717375,4489,63750,1781125,208
507,1272,77667,1233,18875,96542,167,27791,1272,19917,47708,167,486042,1272,20875,506917,167
508,98998,5617458,95905,1297791,6915249,333,1387041,98998,1325041,2712082,208,37069042,98998,1389584,38458626,1458
509,97797,5454000,94741,1354334,6808334,750,1339958,97797,1437167,2777125,333,37000834,97797,1396834,38397668,1000
510,42263,2399250,40943,619041,3018291,375,557375,42263,614209,1171584,292,16007416,42263,632250,16639666,1458
511,25629,1430708,24829,332666,1763374,500,343292,25629,355959,699251,250,9535000,25629,364916,9899916,334
512,92004,5091833,89129,1238583,6330416,417,1411041,92004,1272750,2683791,833,34698292,92004,1239584,35937876,1042
513,64156,3614625,62152,875000,4489625,500,917417,64156,943750,1861167,333,24269000,64156,826959,25095959,1083
514,33941,1820000,32881,493416,2313416,625,477625,33941,453625,931250,292,12721666,33941,474208,13195874,583
515,87457,4974875,84724,1210334,6185209,458,1874000,87457,1278625,3152625,334,33649875,87457,1213833,34863708,708
516,87833,5027458,85089,1177000,6204458,375,1238792,87833,1295041,2533833,250,39326666,87833,1415500,40742166,2875
517,64562,5914250,62545,941542,6855792,1416,959000,64562,1136792,2095792,1208,33421916,64562,2227958,35649874,2958
518,75681,4853375,73316,1090917,5944292,1500,1105833,75681,1127375,2233208,417,30749916,75681,1101500,31851416,1875
519,80581,4810666,78063,1158167,5968833,1333,2793166,80581,1231459,4024625,1959,34197042,80581,1210917,35407959,1625
520,83046,5093750,80451,1197083,6290833,1375,1189250,83046,1215834,2405084,459,32004458,83046,1171583,33176041,1292
521,92968,5607667,90063,1325125,6932792,1208,1348667,92968,1687583,3036250,1208,35188417,92968,1384875,36573292,1625
522,15011,878125,14542,219000,1097125,542,218959,15011,215833,434792,291,5952334,15011,209000,6161334,708
523,5264,301833,5100,74291,376124,542,75792,5264,75833,151625,250,1947834,5264,76000,2023834,208
524,73569,4215625,71270,1015833,5231458,375,1378791,73569,1078917,2457708,250,28471375,73569,1058083,29529458,1917
525,91321,5200917,88468,1269625,6470542,750,1324375,91321,1310958,2635333,583,34867333,91321,1293166,36160499,1209
526,38278,2192709,37082,491500,2684209,625,719208,38278,551791,1270999,333,14600917,38278,532625,15133542,750
527,46524,2636083,45071,597916,3233999,375,639708,46524,666834,1306542,375,17596000,46524,683166,18279166,500
528,96550,5595000,93533,1249875,6844875,917,1318416,96550,1423750,2742166,584,36779459,96550,1352792,38132251,1166
529,61803,3572708,59872,887833,4460541,667,864542,61803,910458,1775000,417,23165666,61803,857750,24023416,958
530,48515,2728416,46999,651584,3380000,542,696167,48515,689500,1385667,458,18635542,48515,703416,19338958,916
531,35040,1974792,33945,450250,2425042,500,464292,35040,503208,967500,416,13138625,35040,457084,13595709,4459
532,96596,5355292,93578,1251250,6606542,458,1341833,96596,1343250,2685083,334,36691833,96596,1420334,38112167,1583
533,54699,3153167,52990,764416,3917583,750,731583,54699,815542,1547125,375,20430334,54699,765666,21196000,792
534,19795,1099791,19177,255250,1355041,375,348791,19795,264584,613375,292,7423083,19795,275333,7698416,334
535,45529,2556250,44107,597834,3154084,375,629583,45529,664833,1294416,333,16974167,45529,703291,17677458,500
536,76785,4217250,74386,986542,5203792,334,1069959,76785,1106500,2176459,250,29333834,76785,1075375,30409209,1125
537,39100,2190459,37879,504000,2694459,416,535542,39100,561084,1096626,291,14482333,39100,594583,15076916,584
538,5404,337875,5236,81458,419333,458,78125,5404,77041,155166,542,1919708,5404,72833,1992541,208
539,81619,4370084,79069,1070084,5440168,333,1673667,81619,1110000,2783667,167,30464959,81619,1134834,31599793,1166
540,57382,3099334,55589,738709,3838043,375,772625,57382,823500,1596125,334,21207666,57382,832542,22040208,459
541,78962,4303833,76495,1022583,5326416,375,1125292,78962,1056500,2181792,292,29667334,78962,1104459,30771793,416
542,88651,4889417,85881,1171500,6060917,250,1371250,88651,1271500,2642750,292,33493875,88651,1436958,34930833,417
543,88065,4935875,85313,1144125,6080000,208,1244000,88065,1266083,2510083,166,32909375,88065,1138250,34047625,458
544,50726,2715541,49141,652375,3367916,375,664458,50726,678250,1342708,208,18709042,50726,732083,19441125,125
545,70634,3816125,68427,911334,4727459,166,1234417,70634,1011584,2246001,166,26678584,70634,1092167,27770751,125
546,80980,4388875,78450,1044375,5433250,166,1101750,80980,1161375,2263125,125,30150500,80980,1156791,31307291,500
547,37015,1981292,35859,481375,2462667,292,490750,37015,495666,986416,167,13553667,37015,521000,14074667,167
548,87094,4706042,84373,1119250,5825292,125,1585000,87094,1269833,2854833,125,32241417,87094,1346458,33587875,250
549,7451,427292,7219,103541,530833,417,107250,7451,107417,214667,333,2783333,7451,104709,2888042,208
550,44428,2518209,43040,572917,3091126,208,793417,44428,636334,1429751,125,16581334,44428,578917,17160251,167
551,38587,2069542,37382,496166,2565708,250,506208,38587,515750,1021958,125,14172208,38587,534500,14706708,125
552,18500,1034709,17922,238041,1272750,125,319958,18500,247375,567333,125,6902958,18500,266625,7169583,166
553,56935,3131042,55156,743709,3874751,125,995167,56935,787458,1782625,125,21344584,56935,789667,22134251,292
554,80799,4394000,78275,1038541,5432541,333,1134125,80799,1162083,2296208,417,30039500,80799,1091541,31131041,250
555,42729,2285083,41394,549292,2834375,208,561125,42729,580208,1141333,167,15819458,42729,593750,16413208,208
556,25489,1464625,24693,333333,1797958,125,618125,25489,341000,959125,125,9524500,25489,361166,9885666,83
557,67830,3745500,65711,873667,4619167,125,1476500,67830,973125,2449625,125,25695375,67830,975792,26671167,125
558,47097,2695875,45626,605166,3301041,167,662125,47097,683417,1345542,167,17623208,47097,605084,18228292,292
559,24235,1296375,23478,311500,1607875,166,328042,24235,324042,652084,125,8741167,24235,354084,9095251,84
560,84501,4543250,81861,1093292,5636542,167,1456000,84501,1136708,2592708,125,31500042,84501,1169250,32669292,125
561,36443,1957417,35305,469333,2426750,166,481667,36443,503708,985375,125,13788708,36443,503625,14292333,250
562,21802,1255125,21121,280750,1535875,125,496750,21802,291542,788292,125,8054334,21802,302541,8356875,167
563,25091,1442667,24307,323042,1765709,125,689916,25091,335792,1025708,125,9678875,25091,366041,10044916,125
564,9519,545792,9222,131459,677251,167,177666,9519,136708,314374,167,3569917,9519,147584,3717501,125
565,27692,1591667,26827,382500,1974167,250,516708,27692,400333,917041,125,10338667,27692,384416,10723083,125
566,95824,5277375,92830,1233500,6510875,125,1846208,95824,1399708,3245916,125,35828792,95824,1472834,37301626,209
567,60236,3229375,58354,776875,4006250,125,861209,60236,852708,1713917,125,22248625,60236,808917,23057542,208
568,89297,4790959,86507,1150125,5941084,208,1186583,89297,1284000,2470583,167,33219250,89297,1179709,34398959,250
569,77803,4165583,75372,999916,5165499,125,1021083,77803,1042708,2063791,250,28601875,77803,1077250,29679125,208
570,5046,289666,4889,69917,359583,83,94041,5046,72834,166875,125,1900875,5046,73209,1974084,83
571,66596,3633625,64515,855834,4489459,125,1256833,66596,913750,2170583,125,25323000,66596,958208,26281208,292
572,31584,1774458,30597,409208,2183666,167,550041,31584,422167,972208,84,11933250,31584,437125,12370375,84
573,86821,4681000,84108,1173833,5854833,167,1135709,86821,1177542,2313251,166,32469459,86821,1201958,33671417,166
574,72926,4033000,70648,941542,4974542,125,1336250,72926,1048500,2384750,125,27197334,72926,1012667,28210001,125
575,9364,539750,9072,129375,669125,167,132792,9364,134750,267542,209,3468750,9364,131750,3600500,3458
576,99523,5439125,96413,1290875,6730000,125,2559000,99523,1428334,3987334,125,36859750,99523,1375291,38235041,334
577,55404,3057000,53673,715000,3772000,125,729833,55404,779208,1509041,166,20955542,55404,852333,21807875,125
578,47370,2597542,45890,609292,3206834,166,621917,47370,678875,1300792,125,17460750,47370,657125,18117875,125
579,41855,2358834,40548,549417,2908251,83,745708,41855,575333,1321041,167,15510958,41855,582208,16093166,375
580,84947,4572750,82293,1096375,5669125,166,1160708,84947,1232625,2393333,167,31935375,84947,1179500,33114875,250
581,57840,3198542,56033,744125,3942667,125,787709,57840,829792,1617501,125,21915250,57840,834625,22749875,833
582,21311,1271083,20646,300500,1571583,375,407750,21311,318208,725958,250,8593084,21311,288709,8881793,1000
583,29703,1738625,28775,408000,2146625,417,1117375,29703,442708,1560083,292,11378417,29703,432166,11810583,584
584,89361,5377792,86569,1283417,6661209,708,2229375,89361,1330708,3560083,375,33713458,89361,1240042,34953500,833
585,72977,4089584,70697,967750,5057334,167,1033916,72977,1047292,2081208,250,27961583,72977,1002125,28963708,583
586,81056,4370042,78523,1061000,5431042,417,1088583,81056,1164333,2252916,292,30650542,81056,1123834,31774376,333
587,4601,273250,4458,63875,337125,250,86458,4601,66375,152833,209,1913291,4601,66625,1979916,458
588,78314,4368000,75867,1016958,5384958,166,1462250,78314,1122000,2584250,83,29522041,78314,1130625,30652666,250
589,58761,3334834,56925,754500,4089334,333,1472875,58761,842458,2315333,167,22200500,58761,810583,23011083,250
590,4528,261583,4387,62792,324375,292,67750,4528,65584,133334,125,1683792,4528,62958,1746750,125
591,69588,3875750,67414,898167,4773917,166,1738125,69588,998125,2736250,125,25734792,69588,1000625,26735417,208
592,36183,1937375,35053,465375,2402750,292,487042,36183,483750,970792,292,13375917,36183,501500,13877417,125
593,74717,4079791,72383,960000,5039791,166,1349875,74717,1070917,2420792,125,27926959,74717,1040208,28967167,250
594,3691,212041,3576,51916,263957,417,52458,3691,53375,105833,167,1385833,3691,51083,1436916,209
595,89682,4873667,86880,1152833,6026500,125,1605209,89682,1285750,2890959,125,33483667,89682,1374208,34857875,417
596,40635,2198625,39366,521709,2720334,125,539667,40635,576917,1116584,125,15158000,40635,564333,15722333,292
597,3041,178459,2946,42084,220543,125,56500,3041,44042,100542,166,1144334,3041,47000,1191334,125
598,24206,1387917,23450,320458,1708375,166,420292,24206,323375,743667,125,9086167,24206,315375,9401542,166
599,93806,5028000,90875,1205666,6233666,125,1236250,93806,1339209,2575459,167,34787542,93806,1212584,36000126,166
600,64589,3456625,62571,835042,4291667,166,914500,64589,863625,1778125,125,23847250,64589,929666,24776916,292
601,43542,2478459,42182,609459,3087918,125,767042,43542,614625,1381667,84,16020959,43542,602125,16623084,416
602,60779,3251042,58880,780750,4031792,250,796041,60779,824042,1620083,166,22791459,60779,839375,23630834,166
603,82058,4447042,79494,1053667,5500709,166,1499792,82058,1180333,2680125,125,30580708,82058,1167708,31748416,208
604,78884,4304916,76419,1015125,5320041,125,1094000,78884,1131542,2225542,125,29289250,78884,1134666,30423916,208
605,85791,4628667,83111,1102417,5731084,209,1217292,85791,1240125,2457417,209,32293541,85791,1200709,33494250,334
606,34715,1942084,33631,446459,2388543,167,455667,34715,481834,937501,167,12897750,34715,484541,13382291,125
607,66481,3679250,64404,856375,4535625,167,1420917,66481,905500,2326417,167,25213542,66481,948584,26162126,167
608,75949,4149167,73576,976500,5125667,125,1062500,75949,1089083,2151583,125,27953625,75949,1060333,29013958,125
609,55885,2999208,54139,719875,3719083,125,748584,55885,768500,1517084,125,21162041,55885,804625,21966666,208
610,51959,2868458,50336,668083,3536541,125,903125,51959,745417,1648542,84,19236541,51959,746583,19983124,125
611,80677,4401291,78156,1043417,5444708,125,1084959,80677,1156584,2241543,167,29957500,80677,1247333,31204833,292
612,91599,4952250,88737,1194625,6146875,250,1293042,91599,1313083,2606125,292,33809750,91599,1347083,35156833,375
613,69367,3711250,67200,891708,4602958,417,948291,69367,994667,1942958,84,25890834,69367,905084,26795918,125
614,28454,1521292,27565,366333,1887625,167,372875,28454,380417,753292,125,10426541,28454,412125,10838666,167
615,73724,4029917,71421,944458,4974375,166,1299125,73724,1056625,2355750,125,27987459,73724,1023500,29010959,1250
616,169,9708,164,3417,13125,500,3417,169,2708,6125,291,63542,169,2583,66125,125
617,35785,2021917,34667,460875,2482792,125,627209,35785,512792,1140001,166,13372334,35785,496959,13869293,208
618,88467,4907125,85703,1176958,6084083,208,1648334,88467,1274167,2922501,208,33660792,88467,1222875,34883667,167
619,90101,5148000,87286,1202334,6350334,167,1431958,90101,1291041,2722999,250,33432750,90101,1214458,34647208,375
620,19651,1051667,19037,255917,1307584,208,280208,19651,262666,542874,250,7227666,19651,274875,7502541,125
621,46317,2526416,44870,641875,3168291,167,807375,46317,618709,1426084,125,17204334,46317,621292,17825626,166
622,96559,5161792,93542,1241416,6403208,166,1301875,96559,1386500,2688375,167,36254541,96559,1343917,37598458,167
623,18850,1085375,18261,260167,1345542,250,266500,18850,270333,536833,167,7007083,18850,259959,7267042,166
624,67206,3838791,65106,873750,4712541,125,1322708,67206,963209,2285917,125,25521834,67206,950959,26472793,1167
625,22307,1332500,21610,319500,1652000,459,482708,22307,332583,815291,333,8527583,22307,303916,8831499,250
626,74559,4381916,72230,955375,5337291,250,1482750,74559,1014375,2497125,125,28049458,74559,1023959,29073417,1375
627,46520,2575584,45067,613584,3189168,625,669292,46520,662833,1332125,375,17717708,46520,686292,18404000,1417
628,1840,106750,1783,27000,133750,4208,27250,1840,27417,54667,708,707750,1840,27125,734875,167
629,21805,1271041,21124,305125,1576166,291,411083,21805,317625,728708,166,8060667,21805,352917,8413584,500
630,46378,2688709,44929,610334,3299043,416,643625,46378,680333,1323958,833,17668083,46378,672125,18340208,750
631,71517,3999291,69283,1001500,5000791,458,1006458,71517,1019792,2026250,250,26770709,71517,969208,27739917,1042
632,60311,3283333,58427,779250,4062583,542,803333,60311,815708,1619041,292,22848000,60311,840417,23688417,458
633,37033,2130542,35876,509958,2640500,250,708500,37033,540083,1248583,167,14313792,37033,482666,14796458,292
634,49701,2707750,48148,638125,3345875,334,650542,49701,663833,1314375,208,18263167,49701,688542,18951709,166
635,86259,4695625,83564,1114833,5810458,125,1558083,86259,1236583,2794666,125,32257000,86259,1192583,33449583,375
636,31411,1804875,30430,433292,2238167,334,442125,31411,450708,892833,167,11784750,31411,434917,12219667,208
637,30036,1725875,29098,413917,2139792,166,554875,30036,430958,985833,125,11362166,30036,417250,11779416,167
638,96441,5464333,93428,1275875,6740208,167,2010375,96441,1391167,3401542,125,36326542,96441,1372708,37699250,1583
639,79054,4356041,76584,1013875,5369916,458,1132708,79054,1082959,2215667,375,29518417,79054,1096292,30614709,4708
640,32390,1911041,31378,447000,2358041,375,467875,32390,467542,935417,375,12336500,32390,448875,12785375,250
641,55094,3216250,53373,778084,3994334,292,1030500,55094,799958,1830458,125,20801333,55094,767292,21568625,834
642,74969,4015708,72627,983667,4999375,584,1042459,74969,1123250,2165709,292,27942416,74969,1043833,28986249,834
643,41144,2245917,39859,528541,2774458,334,573666,41144,563083,1136749,375,15213792,41144,591500,15805292,250
644,70207,3802417,68014,915041,4717458,209,991333,70207,1045000,2036333,250,26171625,70207,975542,27147167,208
645,42821,2461625,41483,552250,3013875,166,1008500,42821,614417,1622917,125,16474625,42821,593792,17068417,250
646,37149,2143208,35989,512333,2655541,125,693667,37149,541750,1235417,166,14072334,37149,521666,14594000,167
647,94940,5269958,91974,1259458,6529416,167,1833875,94940,1362542,3196417,125,35263625,94940,1328208,36591833,375
648,9432,541250,9138,130458,671708,417,187875,9432,135417,323292,125,3530709,9432,131000,3661709,375
649,66689,3643542,64605,860708,4504250,291,1198583,66689,976208,2174791,209,24977167,66689,1030584,26007751,166
650,2320,135208,2248,32083,167291,167,32916,2320,33417,66333,166,908292,2320,32333,940625,167
651,82172,4523250,79605,1055791,5579041,167,2014958,82172,1181750,3196708,125,30784916,82172,1161167,31946083,1166
652,42333,2523583,41011,597583,3121166,458,849875,42333,583125,1433000,250,15625416,42333,587333,16212749,209
653,91421,5065917,88565,1191959,6257876,167,1710041,91421,1352959,3063000,125,34219625,91421,1266459,35486084,958
654,76105,4213416,73727,1020375,5233791,417,1061750,76105,1117708,2179458,250,28472750,76105,1098666,29571416,500
655,49284,2783167,47744,638625,3421792,417,670500,49284,706708,1377208,500,18361958,49284,635042,18997000,291
656,34573,1852792,33493,444875,2297667,334,459750,34573,462542,922292,166,12741875,34573,478208,13220083,167
657,61337,3363208,59421,795625,4158833,209,1222291,61337,879875,2102166,125,22914500,61337,832625,23747125,292
658,91511,4900292,88652,1174000,6074292,375,1217167,91511,1311959,2529126,250,34141250,91511,1229708,35370958,1084
659,64915,3473333,62887,843875,4317208,417,880166,64915,934625,1814791,334,24306083,64915,997375,25303458,333
660,88040,4996750,85289,1150875,6147625,208,1642209,88040,1265875,2908084,167,33459875,88040,1232500,34692375,1375
661,35684,2005791,34569,459000,2464791,417,475291,35684,512125,987416,375,13257708,35684,493208,13750916,125
662,8260,477125,8002,114084,591209,292,116833,8260,118750,235583,208,3157625,8260,116208,3273833,83
663,96751,5358750,93728,1282208,6640958,292,1790458,96751,1391625,3182083,125,36781375,96751,1340750,38122125,708
664,75063,4196625,72718,963625,5160250,250,1067709,75063,1092209,2159918,125,28306000,75063,1080291,29386291,333
665,54298,2919584,52602,696500,3616084,375,718333,54298,728167,1446500,125,19997958,54298,763416,20761374,208
666,14260,806208,13815,183875,990083,166,248042,14260,190750,438792,125,5325750,14260,201125,5526875,208
667,70296,3837958,68100,903042,4741000,209,1256584,70296,988167,2244751,83,26189458,70296,1021542,27211000,500
668,4227,249875,4095,58917,308792,208,59792,4227,60958,120750,125,1585292,4227,59166,1644458,125
669,67309,3688125,65206,868542,4556667,125,1240917,67309,969167,2210084,125,24959167,67309,954625,25913792,250
670,87090,4667500,84369,1119792,5787292,208,1158500,87090,1247916,2406416,125,32341625,87090,1314125,33655750,250
671,98246,5259209,95176,1281041,6540250,167,1384208,98246,1411833,2796041,166,36672834,98246,1318250,37991084,334
672,4024,215666,3899,51959,267625,500,53042,4024,53875,106917,417,1449750,4024,58208,1507958,208
673,18253,1035916,17683,234833,1270749,83,314625,18253,244167,558792,166,6709042,18253,251750,6960792,125
674,88382,4797167,85621,1141541,5938708,83,1794583,88382,1224125,3018708,83,33136083,88382,1224458,34360541,334
675,98784,5394042,95697,1278083,6672125,125,1404875,98784,1416208,2821083,167,36638541,98784,1363917,38002458,250
676,74035,3992167,71722,952750,4944917,250,1028334,74035,1060583,2088917,83,27465833,74035,1065542,28531375,417
677,11435,623000,11078,147125,770125,292,153083,11435,152916,305999,292,4242958,11435,161375,4404333,167
678,2945,172958,2853,41750,214708,167,55875,2945,43416,99291,125,1115583,2945,41000,1156583,125
679,8961,522583,8681,118417,641000,125,155750,8961,119875,275625,166,3273584,8961,124084,3397668,166
680,66455,3648333,64379,850625,4498958,83,1165166,66455,952667,2117833,167,24829875,66455,859708,25689583,292
681,84036,4494875,81410,1082584,5577459,166,1137084,84036,1205042,2342126,166,31697959,84036,1111750,32809709,167
682,69364,3755125,67197,890459,4645584,125,908917,69364,927291,1836208,208,25747375,69364,958250,26705625,208
683,93903,5125167,90969,1203834,6329001,125,1857208,93903,1346292,3203500,209,35189834,93903,1362791,36552625,167
684,57620,3192584,55820,744375,3936959,167,808750,57620,826292,1635042,125,21356042,57620,888417,22244459,917
685,8528,490208,8262,117791,607999,291,116042,8528,114209,230251,375,3117042,8528,120416,3237458,167
686,33538,1973250,32490,431709,2404959,458,486708,33538,448084,934792,375,12301167,33538,468583,12769750,333
687,21758,1248084,21079,279583,1527667,125,386709,21758,292084,678793,166,8313042,21758,290542,8603584,375
688,43319,2339584,41966,557250,2896834,250,774709,43319,578500,1353209,167,16114417,43319,602167,16716584,167
689,66586,3773667,64506,854375,4628042,125,1751917,66586,954125,2706042,84,24897209,66586,963833,25861042,458
690,41206,2218250,39919,529459,2747709,209,541750,41206,553959,1095709,209,15251792,41206,596833,15848625,375
691,78845,4300458,76382,1011750,5312208,166,1437542,78845,1130333,2567875,125,29548416,78845,1143167,30691583,333
692,89227,4856542,86439,1173375,6029917,291,1388750,89227,1279791,2668541,208,33232250,89227,1234750,34467000,375
693,22301,1196459,21605,286792,1483251,208,293750,22301,298208,591958,291,8194667,22301,322750,8517417,166
694,36310,2030708,35176,465958,2496666,166,628917,36310,488333,1117250,166,13910292,36310,498000,14408292,291
695,17143,931167,16608,221000,1152167,209,225542,17143,229375,454917,167,6121083,17143,248833,6369916,167
696,4834,281000,4683,67000,348000,125,90208,4834,69750,159958,166,1828958,4834,67250,1896208,125
697,30775,1701875,29814,395417,2097292,125,616209,30775,411541,1027750,83,11435875,30775,475084,11910959,125
698,98231,5382167,95162,1262250,6644417,167,1908875,98231,1408750,3317625,83,36990292,98231,1520334,38510626,708
699,35550,1966500,34440,457416,2423916,333,470875,35550,512500,983375,583,13377209,35550,496334,13873543,166
700,45236,2553083,43823,582167,3135250,166,830917,45236,656041,1486958,125,16826750,45236,651541,17478291,459
701,81865,4447750,79307,1050583,5498333,167,1122000,81865,1176083,2298083,166,30622667,81865,1164167,31786834,1000
702,87871,4695917,85126,1127417,5823334,333,1164083,87871,1259875,2423958,250,35928792,87871,1362917,37291709,2042
703,87127,5207958,84405,1258291,6466249,1042,1289750,87127,1299292,2589042,1083,34513417,87127,1265041,35778458,1292
704,86555,5163042,83851,1238125,6401167,458,1258708,86555,1302875,2561583,416,33538875,86555,1179542,34718417,791
705,10559,573625,10230,150042,723667,417,155459,10559,157584,313043,334,3978334,10559,151500,4129834,125
706,17212,1100208,16675,253416,1353624,750,258584,17212,257250,515834,250,6798042,17212,248541,7046583,875
707,99920,5837750,96798,1430958,7268708,1375,1386000,99920,1394750,2780750,292,38196709,99920,1579416,39776125,1042
708,40061,2380125,38810,552083,2932208,250,575875,40061,580375,1156250,208,15160250,40061,563959,15724209,708
709,99678,5778833,96564,1375291,7154124,417,2167958,99678,1476833,3644791,250,37815167,99678,1361833,39177000,1292
710,74260,4035417,71940,954500,4989917,541,1042167,74260,1064125,2106292,334,28186416,74260,1034625,29221041,1291
711,38755,2214209,37544,508000,2722209,458,527083,38755,555583,1082666,292,14735709,38755,503375,15239084,667
712,7574,406125,7338,97750,503875,417,99666,7574,101667,201333,500,2755458,7574,105417,2860875,125
713,20021,1151083,19396,284834,1435917,333,376458,20021,274291,650749,209,7572125,20021,279333,7851458,375
714,78736,4358250,76276,1016333,5374583,292,1472250,78736,1176708,2648958,167,29819750,78736,1137875,30957625,1000
715,98512,5610500,95434,1268208,6878708,583,1425625,98512,1425542,2851167,291,37832334,98512,1361958,39194292,708
716,47532,2772333,46047,674583,3446916,583,687375,47532,677333,1364708,375,17825708,47532,613666,18439374,1000
717,94296,5250917,91350,1238042,6488959,417,1467458,94296,1351375,2818833,167,35746833,94296,1345042,37091875,917
718,64609,3832333,62590,911000,4743333,375,948000,64609,929666,1877666,250,24378042,64609,908167,25286209,834
719,89740,4901875,86936,1174458,6076333,583,1266917,89740,1285958,2552875,375,35132250,89740,1297834,36430084,917
720,11535,662667,11175,160167,822834,208,162667,11535,165750,328417,167,4269334,11535,159084,4428418,167
721,21638,1261584,20962,302041,1563625,167,404208,21638,310125,714333,125,8110375,21638,306209,8416584,208
722,28472,1646041,27583,392292,2038333,125,685167,28472,407916,1093083,125,10978583,28472,446625,11425208,125
723,60859,3437625,58958,785041,4222666,208,1124084,60859,872458,1996542,167,22515416,60859,841666,23357082,292
724,31922,1979542,30925,442583,2422125,167,600416,31922,465375,1065791,167,12335291,31922,443000,12778291,208
725,19054,1060917,18459,245083,1306000,125,251666,19054,254959,506625,125,6795083,19054,264708,7059791,167
726,75129,4148208,72782,963875,5112083,209,1346291,75129,1077667,2423958,167,27810583,75129,1038958,28849541,333
727,74021,4273750,71708,1209875,5483625,208,1380833,74021,1060166,2440999,83,28143917,74021,1075666,29219583,542
728,91799,5296167,88931,1266916,6563083,208,1710250,91799,1316916,3027166,167,34252000,91799,1322041,35574041,708
729,33500,1884625,32454,431167,2315792,459,440334,33500,483167,923501,292,12403416,33500,431833,12835249,125
730,22273,1197500,21577,291417,1488917,208,292083,22273,307709,599792,125,8251709,22273,308917,8560626,125
731,20401,1178916,19764,284042,1462958,125,433667,20401,292750,726417,125,7629792,20401,298708,7928500,167
732,83817,4626667,81198,1105042,5731709,125,1560375,83817,1201792,2762167,125,31149625,83817,1170708,32320333,417
733,78067,4275833,75628,1026459,5302292,250,1063083,78067,1119959,2183042,292,29302958,78067,1124417,30427375,250
734,43375,2489333,42020,600958,3090291,250,610458,43375,625792,1236250,125,16269250,43375,603209,16872459,166
735,69516,3941791,67344,913792,4855583,167,1300334,69516,1006750,2307084,83,25994833,69516,1006500,27001333,334
736,98346,5305583,95273,1268083,6573666,208,1363334,98346,1409250,2772584,125,37123000,98346,1354792,38477792,459
737,89000,4914500,86219,1149792,6064292,250,1259375,89000,1280708,2540083,375,33343583,89000,1261458,34605041,583
738,35014,2056458,33920,460250,2516708,333,474250,35014,504583,978833,125,13388292,35014,527834,13916126,1000
739,83813,4479000,81194,1123666,5602666,333,1173250,83813,1238459,2411709,417,31347750,83813,1145459,32493209,916
740,88555,4742000,85788,1149875,5891875,458,1252583,88555,1258292,2510875,333,33825958,88555,1299584,35125542,1125
741,43414,2484709,42058,622334,3107043,625,630875,43414,618792,1249667,375,16884334,43414,629708,17514042,500
742,2240,128959,2170,31125,160084,333,32000,2240,32333,64333,167,836333,2240,32500,868833,125
743,94500,5379334,91547,1346667,6726001,583,1813333,94500,1367125,3180458,333,35919917,94500,1241834,37161751,1000
744,7554,405542,7318,97666,503208,416,146917,7554,101542,248459,250,2778542,7554,106250,2884792,125
745,28685,1689959,27789,370750,2060709,208,497667,28685,383291,880958,125,10938125,28685,414375,11352500,709
746,58483,3343833,56656,757417,4101250,375,1048125,58483,872458,1920583,208,22699375,58483,846583,23545958,667
747,28783,1696916,27884,396792,2093708,375,405541,28783,415708,821249,250,10966750,28783,425667,11392417,791
748,47307,2713833,45829,670500,3384333,125,876959,47307,679459,1556418,84,18205875,47307,708667,18914542,667
749,25539,1469208,24741,352250,1821458,250,472292,25539,365916,838208,125,10260875,25539,353250,10614125,1250
750,45554,2508542,44131,586625,3095167,417,603667,45554,609000,1212667,417,16956167,45554,641792,17597959,1500
751,79631,4717791,77143,1084917,5802708,1042,1128833,79631,1154917,2283750,334,30430375,79631,1162042,31592417,1250
752,45242,2629875,43829,660875,3290750,417,636125,45242,671417,1307542,250,17180750,45242,626208,17806958,625
753,65919,3790375,63860,849625,4640000,208,1254416,65919,966292,2220708,417,25225959,65919,852208,26078167,1042
754,40532,2165667,39266,525583,2691250,542,544792,40532,542000,1086792,375,15107084,40532,581834,15688918,834
755,57584,3234250,55785,805125,4039375,709,838000,57584,804125,1642125,250,21657291,57584,811292,22468583,500
756,42444,2442333,41118,585417,3027750,292,795708,42444,608333,1404041,208,16332500,42444,615042,16947542,708
757,50511,2866250,48933,689125,3555375,583,734833,50511,721875,1456708,1166,18772875,50511,701417,19474292,583
758,88308,4949334,85549,1145750,6095084,500,1628875,88308,1265125,2894000,250,33773833,88308,1251750,35025583,750
759,18232,1046708,17663,251541,1298249,250,256583,18232,262042,518625,250,6837625,18232,262542,7100167,166
760,53121,3087041,51461,748083,3835124,250,952792,53121,773125,1725917,166,19840667,53121,735333,20576000,375
761,34613,1897542,33532,444542,2342084,208,456291,34613,476542,932833,167,13001333,34613,479042,13480375,166
762,34468,1975834,33391,474333,2450167,83,655791,34468,500917,1156708,292,13035583,34468,465541,13501124,125
763,58699,3155042,56865,757917,3912959,292,767875,58699,827084,1594959,167,22046333,58699,905292,22951625,250
764,35100,2019875,34004,484459,2504334,333,650167,35100,503459,1153626,166,13353417,35100,469125,13822542,375
765,86410,4622709,83710,1118834,5741543,209,1161417,86410,1251709,2413126,209,32227709,86410,1188042,33415751,333
766,6897,397458,6682,95375,492833,167,130958,6897,103875,234833,83,2776500,6897,89875,2866375,542
767,19832,1104541,19213,255250,1359791,167,260583,19832,265292,525875,125,7329708,19832,287375,7617083,125
768,55872,3103583,54126,720917,3824500,125,1307458,55872,807792,2115250,166,21018834,55872,780208,21799042,208
769,67865,3870250,65745,889458,4759708,125,1349375,67865,980708,2330083,167,25203542,67865,947000,26150542,167
770,73089,3994958,70805,938500,4933458,166,986000,73089,976875,1962875,125,28043500,73089,1096250,29139750,750
771,58763,3510417,56927,842334,4352751,417,859666,58763,860917,1720583,417,22826500,58763,849250,23675750,625
772,21368,1272792,20701,307333,1580125,625,419584,21368,318708,738292,458,8657542,21368,308416,8965958,959
773,88084,5013834,85332,1169792,6183626,459,1633459,88084,1262291,2895750,333,33161292,88084,1220083,34381375,583
774,86649,5028375,83942,1200084,6228459,416,1232209,86649,1241000,2473209,375,32943083,86649,1218250,34161333,541
775,47077,2516084,45606,606209,3122293,333,616875,47077,629083,1245958,292,17515250,47077,663916,18179166,375
776,60155,3567292,58276,864125,4431417,500,1179375,60155,864000,2043375,209,22762791,60155,867000,23629791,541
777,58890,3313209,57050,764042,4077251,334,789875,58890,849292,1639167,208,21942875,58890,814334,22757209,375
778,70303,4041125,68107,912875,4954000,125,1516041,70303,1006750,2522791,125,26285625,70303,1089208,27374833,958
779,4035,233958,3909,62167,296125,458,62833,4035,58250,121083,417,1464208,4035,53625,1517833,250
780,78327,4347791,75880,1012167,5359958,125,1432833,78327,1147834,2580667,292,29514833,78327,1087875,30602708,708
781,67491,3761708,65382,873125,4634833,459,959291,67491,966750,1926041,333,25044042,67491,897125,25941167,334
782,41788,2250167,40483,537375,2787542,166,548667,41788,604292,1152959,125,15543834,41788,578666,16122500,208
783,82044,4700125,79481,1104000,5804125,208,1527333,82044,1176417,2703750,125,31353417,82044,1138375,32491792,709
784,69061,4000541,66903,972542,4973083,292,1029250,69061,990791,2020041,125,25856250,69061,887375,26743625,292
785,14040,751458,13602,181541,932999,167,184125,14040,187750,371875,291,5191000,14040,196458,5387458,167
786,62296,3410625,60350,800834,4211459,125,1125167,62296,912667,2037834,250,23387208,62296,902916,24290124,334
787,56187,3276458,54432,729459,4005917,125,1030209,56187,805417,1835626,125,21180958,56187,847709,22028667,416
788,43545,2504917,42185,609500,3114417,250,626542,43545,624833,1251375,167,16383166,43545,607208,16990374,250
789,35712,2082542,34596,493375,2575917,292,502250,35712,512125,1014375,167,13353792,35712,505791,13859583,125
790,78538,4517000,76084,1024084,5541084,167,1452333,78538,1126125,2578458,125,29463583,78538,1144542,30608125,334
791,50662,2722167,49079,652333,3374500,250,664792,50662,719500,1384292,250,18769708,50662,731584,19501292,125
792,69951,3867583,67766,899625,4767208,167,1280375,69951,1010167,2290542,167,26001750,69951,1016625,27018375,125
793,86424,4752958,83724,1125625,5878583,167,1231459,86424,1239625,2471084,167,32351083,86424,1189791,33540874,208
794,78943,4476333,76477,1034208,5510541,250,1114584,78943,1131667,2246251,125,29819959,78943,1097833,30917792,167
795,53631,3088584,51956,755375,3843959,166,772958,53631,772042,1545000,125,20013084,53631,743750,20756834,250
796,29256,1680583,28342,407000,2087583,83,639458,29256,424750,1064208,125,11130750,29256,408083,11538833,417
797,65938,3601792,63878,857083,4458875,333,921417,65938,947000,1868417,166,24532542,65938,911333,25443875,166
798,49135,2820084,47600,678792,3498876,125,922292,49135,705042,1627334,166,18533250,49135,681375,19214625,250
799,30282,1737542,29336,418208,2155750,167,428250,30282,434584,862834,167,11234625,30282,420833,11655458,84
800,7423,428917,7192,102916,531833,292,137625,7423,106792,244417,125,2801167,7423,107708,2908875,125
801,60792,3516958,58893,852375,4369333,125,1133958,60792,874833,2008791,125,23023167,60792,840833,23864000,167
802,2368,140459,2294,32834,173293,167,33458,2368,34834,68292,125,916209,2368,33542,949751,208
803,84292,4830709,81658,1125791,5956500,125,1569625,84292,1209000,2778625,167,31336375,84292,1139542,32475917,375
804,45409,2445958,43990,587000,3032958,458,596125,45409,621250,1217375,334,16877125,45409,645958,17523083,208
805,19279,1107042,18677,266375,1373417,375,357834,19279,276583,634417,125,7246209,19279,266541,7512750,125
806,93574,5144334,90650,1211000,6355334,125,1970042,93574,1341375,3311417,166,35171667,93574,1346292,36517959,417
807,41590,2390459,40291,545125,2935584,209,729708,41590,596458,1326166,125,15795083,41590,575750,16370833,166
808,76614,4279333,74220,984292,5263625,208,1833292,76614,1098583,2931875,125,28396292,76614,1097333,29493625,250
809,12685,682375,12289,163750,846125,167,166750,12685,169834,336584,166,4668917,12685,176458,4845375,83
810,68182,3721542,66052,876917,4598459,209,1344000,68182,954041,2298041,125,25619000,68182,945292,26564292,750
811,24390,1411083,23628,336875,1747958,166,345583,24390,350375,695958,125,9043958,24390,347000,9390958,125
812,85845,4873792,83163,1173625,6047417,333,1762167,85845,1265125,3027292,125,32269792,85845,1187458,33457250,208
813,13137,762000,12727,181792,943792,250,185375,13137,188625,374000,166,4870917,13137,182416,5053333,83
814,60598,3488292,58705,836666,4324958,167,1158583,60598,888834,2047417,125,22657792,60598,846167,23503959,125
815,658,42875,638,9666,52541,125,12458,658,9792,22250,125,252959,658,9333,262292,167
816,10179,584416,9861,140583,724999,125,189583,10179,146167,335750,125,3978792,10179,147583,4126375,250
817,21836,1173542,21154,280834,1454376,209,325792,21836,292000,617792,209,7990416,21836,314875,8305291,125
818,30341,1687084,29393,389959,2077043,166,522167,30341,408917,931084,125,11245666,30341,421292,11666958,125
819,84439,4615917,81801,1091709,5707626,166,1696459,84439,1210708,2907167,83,31882208,84439,1171959,33054167,500
820,60224,3315375,58342,774542,4089917,375,845250,60224,863458,1708708,375,22373875,60224,844916,23218791,209
821,3763,221500,3646,52458,273958,125,53041,3763,54292,107333,83,1379416,3763,52500,1431916,125
822,97960,5304084,94899,1263584,6567668,125,1780750,97960,1408167,3188917,125,36812125,97960,1358375,38170500,250
823,50352,2889334,48779,696959,3586293,125,707083,50352,721583,1428666,167,18578959,50352,729083,19308042,208
824,27622,1599959,26759,381625,1981584,125,513708,27622,396334,910042,83,10594125,27622,373958,10968083,167
825,35456,1900500,34348,456416,2356916,208,475584,35456,508584,984168,125,13228250,35456,510708,13738958,125
826,31182,1793333,30208,430083,2223416,166,577125,31182,453125,1030250,167,11662458,31182,477000,12139458,125
827,77836,4479583,75404,1073167,5552750,125,1454750,77836,1114375,2569125,83,28949792,77836,1137667,30087459,250
828,70757,3830667,68546,909792,4740459,250,937166,70757,1015000,1952166,291,26583958,70757,1063833,27647791,167
829,15389,886167,14909,212500,1098667,125,236791,15389,220833,457624,167,5690541,15389,213584,5904125,167
830,71605,3995375,69368,924250,4919625,208,1409375,71605,1030250,2439625,167,26676333,71605,1007458,27683791,167
831,51584,2767583,49972,663125,3430708,167,675250,51584,699958,1375208,125,19253042,51584,748000,20001042,3584
832,20818,1195750,20168,287417,1483167,166,388292,20818,311250,699542,166,8104042,20818,300500,8404542,125
833,94822,5170000,91859,1217917,6387917,125,1336792,94822,1368708,2705500,125,35697834,94822,1315708,37013542,125
834,37261,2140042,36097,482291,2622333,125,487250,37261,532167,1019417,125,13783417,37261,523875,14307292,167
835,91411,5065834,88555,1176834,6242668,125,1687334,91411,1310334,2997668,84,34326666,91411,1280084,35606750,334
836,42250,2410708,40930,543041,2953749,250,580458,42250,606042,1186500,167,15707792,42250,592875,16300667,125
837,93647,5173875,90721,1265250,6439125,167,1768125,93647,1346875,3115000,167,35027875,93647,1357916,36385791,1500
838,12005,692458,11630,154750,847208,708,165292,12005,161042,326334,375,4484542,12005,173500,4658042,250
839,53316,3011334,51650,773500,3784834,500,1342500,53316,757542,2100042,125,34248416,53316,1063709,35312125,2875
840,92927,7403792,90024,1566041,8969833,2084,1427583,92927,1409042,2836625,1208,39960750,92927,1369459,41330209,1375
841,66116,3998167,64050,883625,4881792,1000,911583,66116,953625,1865208,417,25295666,66116,916459,26212125,1041
842,32147,1859958,31143,456125,2316083,250,466542,32147,461750,928292,167,12054000,32147,467333,12521333,125
843,77331,4477167,74915,1083625,5560792,291,1445750,77331,1111958,2557708,125,29493125,77331,1116833,30609958,917
844,89564,4959500,86766,1167167,6126667,625,1263333,89564,1287500,2550833,375,33524584,89564,1284916,34809500,500
845,50003,2740167,48441,661875,3402042,458,678917,50003,717416,1396333,417,18510584,50003,721750,19232334,209
846,8277,475750,8019,120791,596541,291,161458,8277,118958,280416,167,3107500,8277,115542,3223042,125
847,61363,3540333,59446,860250,4400583,208,1133458,61363,883583,2017041,125,23251208,61363,846459,24097667,166
848,34058,1955708,32994,473959,2429667,125,634125,34058,488583,1122708,125,12638000,34058,552833,13190833,83
849,78717,4525166,76258,1089708,5614874,208,1449292,78717,1136375,2585667,167,29256416,78717,1087250,30343666,375
850,22890,1314333,22175,315917,1630250,167,323041,22890,328833,651874,167,8424708,22890,315333,8740041,125
851,78969,4353208,76502,1015292,5368500,125,1617292,78969,1137208,2754500,125,29582083,78969,1220583,30802666,458
852,93109,5173417,90200,1212250,6385667,167,1426917,93109,1334875,2761792,166,34871833,93109,1344625,36216458,500
853,96742,5347875,93719,1258041,6605916,375,1523958,96742,1388208,2912166,416,35972792,96742,1337083,37309875,125
854,19433,1128833,18826,267708,1396541,250,273833,19433,278375,552208,167,7382708,19433,269291,7651999,417
855,26999,1537917,26156,347167,1885084,166,404709,26999,371000,775709,125,9757166,26999,377584,10134750,84
856,28591,1572708,27698,367291,1939999,208,673250,28591,382291,1055541,125,10474167,28591,438541,10912708,125
857,85615,4678208,82940,1099500,5777708,209,1755666,85615,1242667,2998333,166,35322375,85615,1319042,36641417,2167
858,62854,4767041,60890,1915500,6682541,1458,843333,62854,862000,1705333,625,25007333,62854,924875,25932208,1292
859,56317,3249125,54558,725208,3974333,416,770042,56317,816458,1586500,375,21115959,56317,797584,21913543,334
860,51905,2989666,50283,717667,3707333,333,1159292,51905,759041,1918333,125,19788459,51905,721917,20510376,583
861,78802,4362875,76340,1021917,5384792,417,1109500,78802,1143416,2252916,292,29894291,78802,1174625,31068916,1209
862,57192,3185584,55405,746792,3932376,583,803750,57192,821291,1625041,291,21313917,57192,794666,22108583,167
863,47193,2711791,45719,651250,3363041,250,874750,47193,685208,1559958,166,17613709,47193,662542,18276251,584
864,36555,1999417,35413,470958,2470375,250,482042,36555,488792,970834,250,13497541,36555,522792,14020333,208
865,10595,609875,10264,146916,756791,209,197459,10595,152250,349709,292,3927667,10595,146875,4074542,125
866,34789,1996042,33702,450875,2446917,125,604917,34789,469500,1074417,167,13079083,34789,502792,13581875,208
867,75439,4058333,73082,975250,5033583,375,1076875,75439,1081958,2158833,167,27969750,75439,1044417,29014167,208
868,75540,4322542,73180,991000,5313542,208,1434833,75540,1086500,2521333,125,28673791,75540,1048250,29722041,166
869,20593,1188792,19950,289166,1477958,209,301709,20593,295459,597168,125,7711000,20593,284916,7995916,125
870,5819,339958,5638,80541,420499,167,108333,5819,83916,192249,125,2196125,5819,81250,2277375,125
871,32480,1868000,31465,426708,2294708,83,561875,32480,456250,1018125,125,12110750,32480,457750,12568500,166
872,41071,2273458,39788,528125,2801583,125,538875,41071,580041,1118916,167,15315833,41071,573958,15889791,208
873,72459,4082958,70195,945250,5028208,84,1343667,72459,1050875,2394542,167,27415458,72459,1053417,28468875,167
874,97444,5495792,94399,1279667,6775459,292,1375125,97444,1417125,2792250,125,36593959,97444,1354458,37948417,500
875,12249,704250,11867,169583,873833,333,172042,12249,180500,352542,333,4530666,12249,170542,4701208,166
876,58755,3251333,56919,761666,4012999,125,1056750,58755,842416,1899166,125,22013292,58755,909042,22922334,167
877,13472,772458,13051,186125,958583,167,189541,13472,193417,382958,125,5011958,13472,189333,5201291,125
878,92684,5633000,89788,1285792,6918792,1583,1522208,92684,1453750,2975958,1125,34750208,92684,1310042,36060250,958
879,91721,5240916,88855,1180167,6421083,458,1230916,91721,1260417,2491333,375,34431042,91721,1325000,35756042,1583
880,97157,5390916,94121,1346167,6737083,375,1271708,97157,1333209,2604917,291,36195834,97157,1345708,37541542,1125
881,89602,4933667,86802,1171291,6104958,583,1272500,89602,1284917,2557417,459,33667209,89602,1216000,34883209,541
882,52992,2905166,51336,684583,3589749,375,724125,52992,764000,1488125,166,19660333,52992,772750,20433083,208
883,6731,386375,6521,93250,479625,291,126375,6731,96958,223333,167,2526417,6731,93291,2619708,167
884,88735,4891917,85963,1144333,6036250,250,1652834,88735,1296500,2949334,125,33597084,88735,1374000,34971084,250
885,46613,2703542,45157,643791,3347333,333,857750,46613,671584,1529334,250,17699208,46613,670917,18370125,125
886,51200,2940041,49600,707209,3647250,84,945416,51200,738708,1684124,125,19039667,51200,704459,19744126,125
887,99116,5514667,96019,1314875,6829542,84,1853209,99116,1426500,3279709,209,36964333,99116,1427583,38391916,708
888,98414,5636500,95339,1282000,6918500,209,1337416,98414,1315292,2652708,125,36956125,98414,1323375,38279500,375
889,38632,2065583,37425,495958,2561541,166,506000,38632,515958,1021958,375,14205625,38632,557917,14763542,250
890,87622,4793000,84884,1125666,5918666,167,1687959,87622,1262041,2950000,167,32686208,87622,1263166,33949374,250
891,75294,4094375,72942,968375,5062750,125,1017416,75294,1079333,2096749,125,28400583,75294,1079042,29479625,125
892,20336,1166833,19701,280333,1447166,13542,301209,20336,297584,598793,2000,7563584,20336,281292,7844876,166
893,75231,4222125,72881,968875,5191000,1542,1593208,75231,1086333,2679541,375,28087625,75231,1160000,29247625,375
894,87201,4763000,84476,1143750,5906750,334,1231042,87201,1253208,2484250,208,32680375,87201,1131459,33811834,125
895,25963,1392791,25152,333875,1726666,291,342250,25963,347667,689917,292,9580541,25963,384834,9965375,8584
896,53551,2954334,51878,690000,3644334,125,721125,53551,770583,1491708,125,20162708,53551,743083,20905791,1625
897,68113,3843334,65985,877041,4720375,84,956917,68113,979166,1936083,83,25671333,68113,940541,26611874,500
898,69455,3999250,67285,902959,4902209,83,963750,69455,995334,1959084,166,25881667,69455,1004833,26886500,167
899,81288,4372000,78748,1041916,5413916,167,1112750,81288,1164458,2277208,208,30485000,81288,1121666,31606666,333
900,61766,3403375,59836,793250,4196625,167,867791,61766,884583,1752374,333,23018583,61766,860125,23878708,167
901,88598,4946541,85830,1149792,6096333,125,1244500,88598,1270125,2514625,125,33518417,88598,1347500,34865917,250
902,22191,1299709,21498,310625,1610334,125,315000,22191,321000,636000,125,8338666,22191,287625,8626291,292
903,90869,4904542,88030,1170541,6075083,167,1394708,90869,1301458,2696166,125,34011916,90869,1272833,35284749,291
904,42707,2287125,41373,549625,2836750,125,560000,42707,571000,1131000,84,15650041,42707,590167,16240208,167
905,5780,333917,5600,80083,414000,83,81375,5780,83500,164875,42,2170416,5780,84125,2254541,125
906,74895,4123375,72555,964750,5088125,83,1038375,74895,1074084,2112459,84,28164375,74895,1038125,29202500,333
907,21921,1257333,21236,302500,1559833,208,309542,21921,314542,624084,125,8219500,21921,303250,8522750,125
908,53084,3057500,51426,731666,3789166,250,758167,53084,768166,1526333,84,19673333,53084,763250,20436583,166
909,98078,5333917,95014,1273500,6607417,166,1283083,98078,1401875,2684958,125,37045125,98078,1355167,38400292,375
910,84855,4714583,82204,1086209,5800792,125,1198416,84855,1219417,2417833,84,31770875,84855,1171500,32942375,125
911,37266,2139959,36102,513250,2653209,83,526458,37266,534500,1060958,125,13919750,37266,514958,14434708,125
912,47305,2706583,45827,607208,3313791,83,646042,47305,678458,1324500,42,17750416,47305,686792,18437208,83
913,49363,2829917,47821,633333,3463250,83,673167,49363,716041,1389208,125,18868292,49363,715125,19583417,250
914,98102,5490542,95037,1288041,6778583,83,1377167,98102,1406417,2783584,83,36821500,98102,1413958,38235458,459
915,69123,3878375,66963,906750,4785125,292,975166,69123,1021916,1997082,334,25747375,69123,956042,26703417,208
916,79374,4353958,76894,1035917,5389875,83,1124083,79374,1138125,2262208,83,29895459,79374,1148917,31044376,208
917,19147,1099458,18549,263750,1363208,208,295166,19147,274583,569749,83,7117208,19147,277875,7395083,83
918,18028,1034542,17465,248125,1282667,84,256375,18028,258875,515250,42,6650917,18028,249875,6900792,83
919,9844,585875,9537,135625,721500,83,138542,9844,141333,279875,41,3700875,9844,140417,3841292,83
920,63831,3630333,61837,818334,4448667,167,896208,63831,915208,1811416,84,23945709,63831,905083,24850792,125
921,76542,4202292,74151,990416,5192708,125,1084208,76542,1097375,2181583,83,28696666,76542,996625,29693291,417
922,17010,910542,16479,218958,1129500,83,224416,17010,227583,451999,83,6122917,17010,236667,6359584,83
923,90433,4911125,87607,1162541,6073666,167,1269917,90433,1296958,2566875,83,33904583,90433,1248917,35153500,209
924,11672,670208,11308,161333,831541,83,164625,11672,167666,332291,125,4347750,11672,161375,4509125,83
925,55077,3166875,53356,759875,3926750,83,780583,55077,790084,1570667,84,20584625,55077,762459,21347084,83
926,91342,5245792,88488,1260416,6506208,84,1454292,91342,1311291,2765583,84,34569583,91342,1266125,35835708,375
927,760,43750,737,10667,54417,83,11000,760,11250,22250,83,290792,760,10667,301459,41
928,41565,2386708,40267,573625,2960333,83,588875,41565,596083,1184958,125,15623667,41565,581125,16204792,83
929,6831,394208,6618,94833,489041,83,96167,6831,98625,194792,41,2567167,6831,95708,2662875,83
930,2838,168833,2750,39958,208791,83,40500,2838,41416,81916,83,1075292,2838,40000,1115292,42
931,3274,193500,3172,46042,239542,84,46875,3274,47792,94667,83,1202542,3274,45666,1248208,42
932,16457,950375,15943,227375,1177750,84,232959,16457,236334,469293,83,6217250,16457,227542,6444792,42
933,2901,170625,2811,41084,211709,84,41791,2901,43250,85041,42,1065834,2901,40375,1106209,42
934,83913,4815583,81291,1157917,5973500,83,1186333,83913,1211917,2398250,84,31121458,83913,1139167,32260625,250
935,31717,1762625,30726,407791,2170416,125,416625,31717,434083,850708,125,11698750,31717,431416,12130166,84
936,65804,3648834,63748,852416,4501250,83,924792,65804,952791,1877583,208,24707500,65804,948917,25656417,167
937,17089,980875,16555,235958,1216833,83,240208,17089,245208,485416,125,6430625,17089,232042,6662667,125
938,30814,1766500,29852,397333,2163833,41,403292,30814,433708,837000,83,11577208,30814,440125,12017333,83
939,40759,2314208,39486,522709,2836917,42,569625,40759,584750,1154375,83,15706500,40759,563833,16270333,583
940,66998,3748459,64905,861459,4609918,166,1036542,66998,961000,1997542,208,24895167,66998,967209,25862376,375
941,41114,2213959,39830,529208,2743167,250,541958,41114,559000,1100958,125,15255375,41114,595250,15850625,125
942,95708,5392291,92718,1298250,6690541,42,1375417,95708,1394125,2769542,84,36058000,95708,1345958,37403958,167
943,91425,5243083,88568,1260417,6503500,125,1282542,91425,1311125,2593667,83,33960417,91425,1275458,35235875,292
944,45692,2560042,44265,589959,3150001,167,622250,45692,655375,1277625,167,17077750,45692,589875,17667625,84
945,30706,1643041,29747,394667,2037708,42,407958,30706,410583,818541,83,11283708,30706,428458,11712166,83
946,28171,1617042,27291,388917,2005959,83,398750,28171,404208,802958,125,10584125,28171,392417,10976542,125
947,96370,5499500,93359,1262458,6761958,41,1361333,96370,1385959,2747292,84,41775541,96370,1366875,43142416,1459
948,52094,3057000,50467,749250,3806250,417,760875,52094,778250,1539125,458,20173792,52094,756167,20929959,1042
949,68721,3912667,66574,946792,4859459,375,1064334,68721,984667,2049001,375,26250916,68721,991750,27242666,958
950,33552,1856917,32504,435666,2292583,334,454209,33552,498917,953126,291,13001917,33552,488334,13490251,1209
951,9732,569792,9428,135250,705042,375,137625,9732,139958,277583,333,3662875,9732,139334,3802209,334
952,73470,3999750,71175,1039250,5039000,292,1305292,73470,1100666,2405958,1000,27738875,73470,1051875,28790750,958
953,52704,3059208,51057,773750,3832958,416,741917,52704,755666,1497583,334,19448625,52704,756459,20205084,500
954,97557,5224000,94509,1253750,6477750,333,1398250,97557,1437458,2835708,208,36797000,97557,1261042,38058042,709
955,11994,642334,11620,154834,797168,250,157542,11994,161375,318917,416,4376750,11994,170541,4547291,125
956,58788,3250958,56951,754458,4005416,125,951333,58788,841958,1793291,41,22022917,58788,849083,22872000,542
957,12939,752625,12535,179292,931917,208,183250,12939,186000,369250,125,4831916,12939,187250,5019166,83
958,3494,206084,3385,49500,255584,125,50333,3494,51250,101583,83,1311916,3494,48500,1360416,83
959,57656,3311250,55855,795042,4106292,125,813916,57656,826375,1640291,41,21420000,57656,836041,22256041,209
960,88042,4792666,85291,1146250,5938916,125,1236208,88042,1263917,2500125,83,32660083,88042,1278500,33938583,125
961,30960,1774083,29993,398250,2172333,83,407250,30960,432750,840000,83,11520458,30960,428333,11948791,209
962,83037,4847250,80443,1069334,5916584,500,1106833,83037,1190667,2297500,166,31916875,83037,1210125,33127000,3333
963,23262,1389417,22536,334667,1724084,166,342708,23262,347083,689791,375,9049292,23262,333875,9383167,333
964,26944,1608084,26102,386292,1994376,291,396375,26944,401542,797917,209,10494792,26944,386250,10881042,625
965,88190,5283125,85435,1265167,6548292,625,2442958,88190,1748292,4191250,1375,33044916,88190,1270417,34315333,1000
966,18942,1089625,18351,274458,1364083,417,268416,18942,271792,540208,209,7215709,18942,261250,7476959,208
967,14297,837792,13851,204917,1042709,125,204917,14297,208417,413334,83,5364083,14297,206917,5571000,125
968,5006,293666,4850,70417,364083,84,70708,5006,72166,142874,42,1883459,5006,69791,1953250,125
969,29753,1712209,28824,410625,2122834,42,423833,29753,430750,854583,42,11124958,29753,410709,11535667,125
970,98261,5771375,95191,1388709,7160084,583,1390375,98261,1399708,2790083,166,37686750,98261,1423334,39110084,1375
971,28812,1702833,27912,378083,2080916,625,420208,28812,385708,805916,417,10983292,28812,415375,11398667,375
972,62312,3375625,60365,819458,4195083,417,844416,62312,922708,1767124,500,24180375,62312,867083,25047458,1333
973,48716,2759917,47194,626584,3386501,334,745625,48716,717916,1463541,458,18145292,48716,703375,18848667,208
974,52357,2881792,50721,672375,3554167,208,732500,52357,750167,1482667,250,19401750,52357,754000,20155750,250
975,89741,5103584,86937,1173125,6276709,83,1268584,89741,1288625,2557209,125,33721167,89741,1247666,34968833,250
976,72724,4158875,70452,962959,5121834,208,1029583,72724,1043125,2072708,208,27553917,72724,1004375,28558292,83
977,70074,4029541,67885,966208,4995749,125,995000,70074,1004666,1999666,83,26277042,70074,1013625,27290667,250
978,89797,4811500,86991,1200458,6011958,417,1245667,89797,1287458,2533125,208,33462000,89797,1242083,34704083,583
979,91116,4909833,88269,1173917,6083750,334,1269541,91116,1309750,2579291,209,34124750,91116,1266083,35390833,41
980,40067,2298584,38815,572833,2871417,209,563709,40067,577375,1141084,83,14925958,40067,552500,15478458,42
981,43827,2519208,42458,604125,3123333,41,621083,43827,631625,1252708,83,16384042,43827,609792,16993834,41
982,49504,2844875,47957,683959,3528834,84,696833,49504,711583,1408416,83,19013542,49504,682625,19696167,167
983,81499,4682709,78953,1127875,5810584,83,1159542,81499,1173083,2332625,83,30430500,81499,1138791,31569291,167
984,63176,3476083,61202,813708,4289791,167,842417,63176,913792,1756209,125,23434875,63176,910875,24345750,167
985,36538,1996833,35397,469250,2466083,125,480166,36538,488709,968875,83,13475541,36538,506250,13981791,41
986,38804,2232875,37592,537792,2770667,84,551250,38804,560041,1111291,84,14578500,38804,536416,15114916,83
987,70325,4045250,68128,969167,5014417,125,996041,70325,1008542,2004583,83,26054375,70325,972333,27026708,375
988,35215,1988167,34115,452959,2441126,84,467208,35215,505125,972333,125,13079209,35215,492667,13571876,83
989,94052,5205250,91113,1247125,6452375,167,1334625,94052,1352625,2687250,83,35210167,94052,1306542,36516709,166
990,24491,1408083,23726,338167,1746250,250,344292,24491,351416,695708,42,9246209,24491,353792,9600001,375
991,43032,2433542,41688,552417,2985959,250,582833,43032,619250,1202083,125,16007083,43032,597917,16605000,42
992,23523,1353083,22788,323792,1676875,125,330750,23523,337291,668041,83,8885750,23523,324875,9210625,250
993,5262,304917,5098,72833,377750,83,76208,5262,82875,159083,83,1977208,5262,71792,2049000,83
994,59495,3409125,57636,763125,4172250,125,925041,59495,852625,1777666,83,22831958,59495,833667,23665625,125
995,59413,3434542,57557,832625,4267167,84,834209,59413,856166,1690375,125,22340917,59413,820875,23161792,209
996,44123,2373167,42745,567500,2940667,125,589333,44123,623583,1212916,83,16382583,44123,615500,16998083,42
997,38083,2187042,36893,525375,2712417,125,535875,38083,546459,1082334,84,14358916,38083,512500,14871416,250
998,49339,2638958,47798,634792,3273750,166,653958,49339,707750,1361708,125,18287959,49339,682667,18970626,83
999,10763,622500,10427,148625,771125,84,151834,10763,154416,306250,83,4038334,10763,165875,4204209,125
